FLNC	autosomal dominant
LRRC23	autosomal recessive
SAMD7	autosomal recessive
CFAP61	autosomal recessive
ARMC12	autosomal recessive
DAW1	autosomal recessive
MINAR2	autosomal recessive
HECTD4	autosomal recessive
RNU12	autosomal recessive
CFAP74	autosomal recessive
IQCN	autosomal recessive
CENATAC	autosomal recessive
TMEM151A	autosomal dominant
LTV1	autosomal recessive
C18orf32	autosomal recessive
RAB5IF	autosomal recessive
TMEM63C	autosomal recessive
MYMX	autosomal recessive
CCDC146	autosomal recessive
C2CD6	autosomal recessive
TMEM53	autosomal recessive
CIROP	autosomal recessive
RPL10L	autosomal recessive
ZFYVE19	autosomal recessive
AOPEP	autosomal recessive
AFG2B	autosomal recessive
CLXN	autosomal recessive
PNLDC1	autosomal recessive
LMBRD2	autosomal dominant
PAPPA2	autosomal recessive
TMEM222	autosomal recessive
RRP7A	autosomal recessive
CATIP	autosomal recessive
SNORA31	autosomal dominant
LYSET	autosomal recessive
TMEM218	autosomal recessive
HRURF	autosomal dominant
ACTL9	autosomal recessive
C2orf69	autosomal recessive
HS3ST6	autosomal dominant
SLC7A6OS	autosomal recessive
TBC1D2B	autosomal recessive
CFAP58	autosomal recessive
YIF1B	autosomal recessive
M1AP	autosomal recessive
TTC5	autosomal recessive
HPDL	autosomal recessive
CLRN2	autosomal recessive
VPS35L	autosomal recessive
CEP112	autosomal recessive
TMEM163	autosomal dominant
CCDC32	autosomal recessive
ZNFX1	autosomal recessive
DALRD3	autosomal recessive
CEP85L	autosomal dominant
THG1L	autosomal recessive
CCDC134	autosomal recessive
TTC29	autosomal recessive
NEK10	autosomal recessive
NTNG2	autosomal recessive
TMEM63A	autosomal dominant
CFAP70	autosomal recessive
PERCC1	autosomal recessive
NUTM2B-AS1	autosomal dominant
METTL5	autosomal recessive
WDR37	autosomal dominant
TRIM71	autosomal dominant
RABL3	autosomal dominant
NDUFAF8	autosomal recessive
HEPHL1	autosomal recessive
USP45	autosomal recessive
ARMC2	autosomal recessive
REC114	autosomal recessive
FAM149B1	autosomal recessive
CAP2	autosomal recessive
TRAPPC14	autosomal recessive
CYBC1	autosomal recessive
PRDM10	autosomal dominant
RPL35	autosomal dominant
QRICH2	autosomal recessive
LRP12	autosomal dominant
NHLRC2	autosomal recessive
ZNF341	autosomal recessive
CCDC47	autosomal recessive
MYORG	autosomal recessive
LRRC56	autosomal recessive
PITRM1	autosomal recessive
TMTC4	autosomal recessive
DNAJC30	autosomal recessive
ZBTB11	autosomal recessive
TMEM94	autosomal recessive
PPP1R21	autosomal recessive
CFAP251	autosomal recessive
GDAP2	autosomal recessive
KASH5	autosomal recessive
PMFBP1	autosomal recessive
WBP11	autosomal dominant
SAMD12	autosomal dominant
COX16	autosomal recessive
CFAP300	autosomal recessive
INAVA	autosomal dominant (with incomplete penetrance)
SHOC1	autosomal recessive
NOTCH2NLC	autosomal dominant
RNPC3	autosomal recessive
METTL13	autosomal dominant
TDRD9	autosomal recessive
CFAP69	autosomal recessive
ERGIC1	autosomal recessive
LSM11	autosomal recessive
TUBA3D	autosomal dominant
RNU7-1	autosomal recessive
NAF1	autosomal dominant
SVBP	autosomal recessive
TRIT1	autosomal recessive
ZFHX2	autosomal dominant
BRWD1	autosomal recessive
TUBGCP2	autosomal recessive
GREB1L	autosomal dominant
TXNDC15	autosomal recessive
CEP295	autosomal recessive
TBC1D23	autosomal recessive
MEIOB	autosomal recessive
LIPT2	autosomal recessive
SQOR	autosomal recessive
IQCE	autosomal recessive
MSTO1	autosomal recessive, autosomal dominant
TOGARAM1	autosomal recessive
ARMC9	autosomal recessive
ALPK3	autosomal recessive
CLDN10	autosomal recessive
DZIP1L	autosomal recessive
KIF15	autosomal recessive
CFAP44	autosomal recessive
CFAP43	autosomal dominant|autosomal recessive
CLCC1	autosomal recessive
EFL1	autosomal recessive
COLGALT1	autosomal recessive
OGDHL	autosomal recessive
VWA8	autosomal dominant
NSUN3	autosomal recessive
WDFY3	autosomal dominant
POLR3GL	autosomal recessive
POLR3F	autosomal dominant
IFT56	autosomal recessive
TMEM260	autosomal recessive
USP48	autosomal dominant
GON7	autosomal recessive
USP53	autosomal recessive
WDR26	autosomal dominant
RPL3L	autosomal recessive
PRUNE1	autosomal recessive
QRICH1	autosomal dominant
MYL11	autosomal dominant, autosomal recessive
ZNF462	autosomal dominant
DHX37	autosomal dominant (sex limited)|autosomal recessive
DYNLT2B	autosomal recessive
PTRHD1	autosomal recessive
TERB1	autosomal recessive
C14orf39	autosomal recessive
DENND5A	autosomal recessive
DNHD1	autosomal recessive
CIBAR1	autosomal recessive
KIAA0825	autosomal recessive
NSMCE2	autosomal recessive
HECW2	autosomal dominant
TECRL	autosomal recessive
HKDC1	autosomal recessive
PYROXD1	autosomal recessive
TMTC3	autosomal recessive
GATC	autosomal recessive
QRSL1	autosomal recessive
NSUN6	autosomal recessive
CWC27	autosomal recessive
TERB2	autosomal recessive
KIAA0753	autosomal recessive
CEP78	autosomal recessive
ZNF668	autosomal recessive
ODAD4	autosomal recessive
IFT52	autosomal recessive
NEPRO	autosomal recessive
DYNC2LI1	autosomal recessive
GUF1	autosomal recessive
CTU2	autosomal recessive
DNAJC21	autosomal recessive
ACER3	autosomal recessive
PRDM6	autosomal dominant
MTSS2	autosomal dominant
PIGG	autosomal recessive
TBCK	autosomal recessive
EMC1	autosomal recessive
TANGO2	autosomal recessive
THSD1	autosomal dominant|autosomal recessive
TMEM199	autosomal recessive
SYCP2L	autosomal recessive
MAPKBP1	autosomal recessive
TUBB8	autosomal dominant, autosomal recessive
KDF1	autosomal dominant
PRDM13	autosomal recessive
CCDC174	autosomal recessive
TMX2	autosomal recessive
STARD7	autosomal dominant
CEP104	autosomal recessive
SNORD118	autosomal recessive
THUMPD1	autosomal recessive
MORC2	autosomal dominant
MICOS13	autosomal recessive
SIPA1L3	autosomal recessive
KATNIP	autosomal recessive
KRT25	autosomal recessive
PRDM8	autosomal recessive
PRR12	autosomal dominant
ACBD5	autosomal recessive
CSGALNACT1	autosomal recessive
RSPRY1	autosomal recessive
SPAG17	autosomal recessive
NDNF	autosomal dominant
UBAP2L	autosomal dominant
VPS50	autosomal recessive
PRDM12	autosomal recessive
ZNF408	autosomal dominant|autosomal recessive
OVOL2	autosomal dominant
SLC32A1	autosomal dominant
ARHGEF18	autosomal recessive
DHX30	autosomal dominant
TEFM	autosomal recessive
ADGRL1	autosomal dominant
PYCR2	autosomal recessive
POLR1A	autosomal dominant|autosomal recessive
KCTD17	autosomal dominant
ZCCHC8	autosomal dominant
SCYL2	autosomal recessive
COQ5	autosomal recessive
ACBD6	autosomal recessive
CHAMP1	autosomal dominant
LEMD2	autosomal recessive|autosomal dominant
FRMD5	autosomal dominant
FRMD4A	autosomal recessive
FLG2	autosomal recessive
PUS3	autosomal recessive
PUS7	autosomal recessive
CLPB	autosomal dominant|autosomal recessive
GSX2	autosomal recessive
CHCHD2	autosomal dominant
CREB3L1	autosomal recessive
ZNF292	autosomal dominant
TMEM107	autosomal recessive
TMEM132E	autosomal recessive
DDRGK1	autosomal recessive
CKAP2L	autosomal recessive
NSRP1	autosomal recessive
SLC25A36	autosomal recessive
TGDS	autosomal recessive
WDR73	autosomal recessive
RNF220	autosomal recessive
CWF19L1	autosomal recessive
LMOD3	autosomal recessive
TOP6BL	autosomal recessive
FAR1	autosomal dominant|autosomal recessive
SNX14	autosomal recessive
TMEM240	autosomal dominant
UQCC3	autosomal recessive
SPRTN	autosomal recessive
FERRY3	autosomal recessive
ANKLE2	autosomal recessive
ELP2	autosomal recessive
ANLN	autosomal dominant
SCAF4	autosomal dominant
TRMT10A	autosomal recessive
JAGN1	autosomal recessive
COA8	autosomal recessive
ODAD3	autosomal recessive
ZSWIM6	autosomal dominant
SPEG	autosomal recessive
TMEM98	autosomal dominant
C2CD3	autosomal recessive
ANKRD17	autosomal dominant
NAXD	autosomal recessive
CHCHD10	autosomal dominant
PPP2R3C	autosomal recessive|autosomal dominant
AGBL5	autosomal recessive
ZNF407	autosomal recessive
RSPH3	autosomal recessive
IFT27	autosomal recessive
VPS53	autosomal recessive
CEP83	autosomal recessive
TKFC	autosomal recessive
DEGS1	autosomal recessive
LYRM7	autosomal recessive
DCAF8	autosomal dominant
CLDN9	autosomal recessive
FSIP2	autosomal recessive
NUDT15	autosomal dominant
AHDC1	autosomal dominant
NADK2	autosomal recessive
AP1S3	autosomal dominant
GRXCR2	autosomal recessive
KIDINS220	autosomal dominant|autosomal recessive
KIZ	autosomal recessive
WASHC4	autosomal recessive
SETD5	autosomal dominant
VPS51	autosomal recessive
DOCK7	autosomal recessive
SLC7A14	autosomal recessive
OTULIN	autosomal dominant|autosomal recessive
PLD3	autosomal dominant
HFM1	autosomal recessive
ERCC6L2	autosomal recessive
NCAPD2	autosomal recessive
CDIN1	autosomal recessive
COA7	autosomal recessive
KPTN	autosomal recessive
POGLUT1	autosomal dominant|autosomal recessive
CLPX	autosomal dominant
NUP188	autosomal recessive
CEP19	autosomal recessive
SLC38A8	autosomal recessive
FAM111B	autosomal dominant
COQ8B	autosomal recessive
SFXN4	autosomal recessive
ARMC5	autosomal dominant, somatic mutation
SYNE4	autosomal recessive
TIMMDC1	autosomal recessive
TMEM126B	autosomal recessive
ERMARD	autosomal dominant
STAC3	autosomal recessive
MIEF2	autosomal recessive
MIEF1	autosomal dominant
AGBL1	autosomal dominant
GMPPA	autosomal recessive
CFAP298	autosomal recessive
DDX59	autosomal recessive
SZT2	autosomal recessive
DYNC2I1	autosomal recessive
ELMOD3	autosomal dominant|autosomal recessive
TRMT10C	autosomal recessive
PRIMPOL	autosomal dominant
BHLHA9	autosomal recessive
MRAP2	autosomal dominant
ODAD2	autosomal recessive
ARL2BP	autosomal recessive
TM4SF20	autosomal dominant
THOC6	autosomal recessive
SPIDR	autosomal recessive
ANKS6	autosomal recessive
AK7	autosomal recessive
AK9	autosomal recessive
LRIF1	digenic, recessive
MYMK	autosomal recessive
KLHL40	autosomal recessive
IRF2BP2	autosomal dominant
EXOC2	autosomal recessive
NRROS	autosomal recessive
GMPPB	autosomal recessive
ISCA2	autosomal recessive
IBA57	autosomal recessive
ADAT3	autosomal recessive
FAM111A	autosomal dominant
B3GALT6	autosomal recessive
DRC1	autosomal recessive
EXOC8	autosomal recessive
CERS3	autosomal recessive
METTL23	autosomal recessive
POMK	autosomal recessive
SMIM1	autosomal recessive
KCNU1	autosomal recessive
ATP5MK	autosomal recessive
PGAP2	autosomal recessive
TLCD3B	autosomal recessive
C12orf57	autosomal recessive
ASXL3	autosomal dominant
TUBB6	autosomal dominant
TUBB2A	autosomal dominant
MGME1	autosomal recessive
EPG5	autosomal recessive
ASB10	autosomal dominant
WAC	autosomal dominant
TANC2	autosomal dominant
ODAD1	autosomal recessive
OR2J3	autosomal dominant
LRIT3	autosomal recessive
DDHD2	autosomal recessive
TECPR2	autosomal recessive
GATAD2B	autosomal dominant
EPS8L3	autosomal dominant
EPS8L2	autosomal recessive
DHTKD1	autosomal dominant|autosomal recessive
SMCHD1	autosomal dominant|digenic, dominant
SLFN14	autosomal dominant
HEATR3	autosomal recessive
TMEM231	autosomal recessive
TAMM41	autosomal recessive
DNAAF11	autosomal recessive
OTOGL	autosomal recessive
PTCD3	autosomal recessive
RMND1	autosomal recessive
HIKESHI	autosomal recessive
BCKDK	autosomal recessive
AAGAB	autosomal dominant
VWA3B	autosomal recessive
DNAAF5	autosomal recessive
CEP164	autosomal recessive
ODAPH	autosomal recessive
POMGNT2	autosomal recessive
REPS1	autosomal recessive
EOGT	autosomal recessive
POGZ	autosomal dominant
MFF	autosomal recessive
POC1B	autosomal recessive
POC1A	autosomal recessive
SNX10	autosomal recessive
SIK3	autosomal recessive
COA3	autosomal recessive
COA6	autosomal recessive
PET117	autosomal recessive
PET100	autosomal recessive
CFAP53	autosomal recessive
IFITM5	autosomal dominant
MPC1	autosomal recessive
PIGO	autosomal recessive
TMEM165	autosomal recessive
SERAC1	autosomal recessive
CEP63	autosomal recessive
CDK19	autosomal dominant
KNSTRN	digenic recessive
SCUBE3	autosomal recessive
COX20	autosomal recessive
PHYKPL	autosomal recessive
CCDC103	autosomal recessive
MTO1	autosomal recessive
CCDC78	autosomal dominant
PATL2	autosomal recessive
RNF170	autosomal dominant|autosomal recessive
COQ6	autosomal recessive
MYO1H	autosomal recessive
UVSSA	autosomal recessive
CRPPA	autosomal recessive
IFT140	autosomal recessive
KANK2	autosomal recessive
FOCAD	autosomal recessive
DDHD1	autosomal recessive
CEACAM16	autosomal dominant|autosomal recessive
SKIC3	autosomal recessive
FDX2	autosomal recessive
P4HTM	autosomal recessive
ROGDI	autosomal recessive
CPLANE1	autosomal recessive
DIAPH3	autosomal dominant
DNAAF3	autosomal recessive
ARID1B	autosomal dominant
EMC10	autosomal recessive
LRMDA	autosomal recessive
ZSWIM7	autosomal recessive
NDUFA12	autosomal recessive
GATAD1	autosomal recessive
GPR179	autosomal recessive
TOR1AIP1	autosomal recessive
MDFIC	autosomal recessive
BRAT1	autosomal recessive
FKBP14	autosomal recessive
MCAT	autosomal recessive
COX14	autosomal recessive
CFAP418	autosomal recessive
THSD4	autosomal dominant
UQCC2	autosomal recessive
TMEM138	autosomal recessive
UBE3C	autosomal recessive
ATAD1	autosomal recessive
TSHZ1	autosomal dominant
TTI2	autosomal recessive
TTI1	autosomal recessive
TMEM237	autosomal recessive
RHBDF2	autosomal dominant
MFSD2A	autosomal recessive
ZNF526	autosomal recessive
PRRT2	autosomal dominant
POLR3B	autosomal dominant|autosomal recessive
NUP205	autosomal recessive
NUP93	autosomal recessive
PAM16	autosomal recessive
ZMYND15	autosomal recessive
C19orf12	autosomal recessive|autosomal recessive, autosomal dominant
BICC1	autosomal dominant
ESAM	autosomal recessive
CFAP65	autosomal recessive
C9orf72	autosomal dominant
POLR3A	autosomal recessive
NAA60	autosomal recessive
ACSF3	autosomal recessive
OPLAH	autosomal recessive, autosomal dominant
PDZD8	autosomal recessive
HSD11B2	autosomal recessive
WDR81	autosomal recessive
ASCC3	autosomal recessive
ASCC1	autosomal recessive
DOCK6	autosomal recessive
DEPDC5	autosomal recessive|autosomal dominant
DIS3L2	autosomal recessive
NBEAL2	autosomal recessive
PCK1	autosomal recessive
PRDM5	autosomal recessive
ZNF644	autosomal dominant
NOP56	autosomal dominant
RFWD3	autosomal recessive
PKDCC	autosomal recessive
CCDC8	autosomal recessive
B9D1	autosomal recessive
TRIM2	autosomal recessive
SPECC1L	autosomal dominant
TRAPPC12	autosomal recessive
TRAPPC11	autosomal recessive
TMCO1	autosomal recessive
KPNA7	autosomal recessive
MLIP	autosomal recessive
PCK2	autosomal recessive, also a cytosolic form (261680)
RILPL1	autosomal dominant
MCIDAS	autosomal recessive
WEE2	autosomal recessive
MYZAP	autosomal recessive
IFT43	autosomal recessive
ZBTB24	autosomal recessive
CDC42BPB	autosomal dominant
KHK	autosomal recessive
RB1	somatic mutation|autosomal dominant, somatic mutation|autosomal dominant
DAGLA	autosomal dominant
BPNT2	autosomal recessive
FANCD2	autosomal recessive
PRPF6	autosomal dominant
FANCE	autosomal recessive
SUN5	autosomal recessive
AFG2A	autosomal recessive
TNNI3K	autosomal dominant
TOE1	autosomal recessive
C2	digenic dominant|autosomal recessive
LIPN	autosomal recessive
COA5	autosomal recessive
ZBTB42	autosomal recessive
TGM6	autosomal dominant
FANCC	autosomal recessive with at least two loci and multiple alleles
HMGCL	autosomal recessive
FANCF	autosomal recessive
BPGM	autosomal recessive
DPY19L2	autosomal recessive
UMPS	autosomal recessive
HSD3B2	autosomal recessive
TRH	autosomal recessive
F7	autosomal recessive
F10	autosomal recessive
FAH	autosomal recessive
PLAAT3	autosomal recessive
PRSS56	autosomal recessive
TCTN3	autosomal recessive
TCTN2	autosomal recessive
UQCRH	autosomal recessive
GZF1	autosomal recessive
UBR7	autosomal recessive
CYP21A2	autosomal recessive
TTC19	autosomal recessive
CCDC40	autosomal recessive
CCDC39	autosomal recessive
C1R	autosomal dominant
CAMSAP1	autosomal recessive
RNF213	autosomal dominant, autosomal recessive
G6PC1	autosomal recessive
PYGL	autosomal recessive
CCDC115	autosomal recessive
MEN1	autosomal dominant
KBTBD13	autosomal dominant
ANO10	autosomal recessive
MSRB3	autosomal recessive
POLR1D	autosomal dominant, autosomal recessive
SLC25A20	autosomal recessive
MTPAP	autosomal recessive
SOBP	autosomal recessive
ALG11	autosomal recessive
ACKR1	autosomal dominant, autosomal recessive (null phenotype)|autosomal recessive
SHQ1	autosomal recessive
KCNK18	autosomal dominant
AP5Z1	autosomal recessive
EIF2AK1	autosomal dominant
PIEZO2	autosomal dominant|autosomal recessive
FOXRED1	autosomal recessive
NUBPL	autosomal recessive
SCARF2	autosomal recessive
HFE	autosomal recessive
BBIP1	autosomal recessive
WDR35	autosomal recessive
ABHD12	autosomal recessive
ZNF513	autosomal recessive
HOGA1	autosomal recessive
FAM161A	autosomal recessive
TMEM147	autosomal recessive
WDR62	autosomal recessive
WDPCP	autosomal recessive
TBC1D24	autosomal dominant|autosomal recessive
TET3	autosomal dominant, autosomal recessive
XPNPEP3	autosomal recessive
MTRFR	autosomal recessive
SPTSSA	autosomal dominant
FAN1	autosomal recessive
CEP152	autosomal recessive
SDCCAG8	autosomal recessive
OPN1SW	autosomal dominant (7q31.3-q32)
UROD	autosomal dominant, autosomal recessive
RUBCN	autosomal recessive
LIPA	autosomal recessive
SPEN	autosomal dominant
CCDC62	autosomal recessive
HPSE2	autosomal recessive
ASAH1	autosomal recessive
MIA3	autosomal recessive
CEP120	autosomal recessive
TCN2	autosomal recessive
FCHO1	autosomal recessive
PCARE	autosomal recessive
KCTD1	autosomal dominant
TMEM106B	autosomal dominant
LACC1	autosomal recessive
MIR2861	autosomal dominant, autosomal recessive
TMEM127	autosomal dominant
VIPAS39	autosomal recessive
AVIL	autosomal recessive
POMP	autosomal recessive|autosomal dominant
CBS	autosomal recessive
YEATS2	autosomal dominant
DYNC2I2	autosomal recessive
DRAM2	autosomal recessive
TPRN	autosomal recessive
RSRC1	autosomal recessive
SLC52A3	autosomal recessive
OAT	autosomal recessive
KIAA1549	autosomal recessive
DPYS	autosomal recessive
LYRM4	autosomal recessive
ALKBH8	autosomal recessive
FEZF1	autosomal recessive
MARCHF6	autosomal dominant
UBA2	autosomal dominant
SH3PXD2B	autosomal recessive
ATXN8	autosomal dominant
GRXCR1	autosomal recessive
ZC3H14	autosomal recessive
SLX4	autosomal recessive
TMEM216	autosomal recessive
USB1	autosomal recessive
MOCOS	autosomal recessive
PPP1R15B	autosomal recessive
PLIN4	autosomal dominant
KCNJ18	autosomal dominant
KIF26A	autosomal recessive
PEPD	autosomal recessive
AGA	autosomal recessive
CYB5A	autosomal recessive
WDR72	autosomal recessive
CYB5R3	autosomal recessive
XPC	autosomal recessive
DNAAF1	autosomal recessive
BOLA3	autosomal recessive
SMG9	autosomal recessive
SMG8	autosomal recessive
RBM20	autosomal dominant
KLHDC8B	autosomal recessive
SERPINF2	autosomal recessive
CANT1	autosomal recessive
VWF	autosomal dominant|autosomal recessive|autosomal dominant, autosomal recessive
MIR184	autosomal dominant
TSPAN12	autosomal dominant
CTC1	autosomal recessive
STN1	autosomal recessive
NEXN	autosomal dominant
RETREG1	autosomal recessive
NF1	autosomal dominant, somatic mutation|autosomal dominant
CTSA	autosomal recessive
GM2A	autosomal recessive
MYT1L	autosomal dominant
LOXHD1	autosomal recessive
INPP5E	autosomal recessive
PMPCA	autosomal recessive
OGDH	autosomal recessive
SDHAF2	autosomal dominant
TAT	autosomal recessive
UROC1	autosomal recessive
SEPSECS	autosomal recessive
HTT	autosomal dominant|autosomal recessive
RAB28	autosomal recessive
ASXL2	autosomal dominant
ASXL1	autosomal dominant
TMEM126A	autosomal recessive
PDZD7	autosomal recessive|autosomal recessive, digenic dominant (see miscellaneous)
ESRP1	autosomal recessive
TACO1	autosomal recessive
RNASET2	autosomal recessive
PGAM2	autosomal recessive
TSPEAR	autosomal recessive
NDUFAF3	autosomal recessive
TRNT1	autosomal recessive
TUBB1	autosomal dominant
COQ4	autosomal recessive
NXN	autosomal recessive
EXPH5	autosomal recessive
PHIP	autosomal dominant
ALG14	autosomal recessive
TUBB2B	autosomal dominant
SDHAF1	autosomal recessive
TET2	autosomal recessive
COQ9	autosomal recessive
PLCH1	autosomal recessive
PHLDB1	autosomal recessive
TARS2	autosomal recessive
SARS2	autosomal recessive
NARS2	autosomal recessive
VARS2	autosomal recessive
IARS2	autosomal recessive
CARS2	autosomal recessive
EARS2	autosomal recessive
PTDSS1	autosomal dominant
DPYD	autosomal recessive
SETD2	autosomal dominant
BCAM	autosomal recessive
DUOXA2	autosomal recessive
PISD	autosomal recessive
SMARCAD1	autosomal dominant
TAPT1	autosomal recessive
GPIHBP1	autosomal recessive
CCBE1	autosomal recessive
SPACA1	autosomal recessive
CPOX	autosomal dominant, autosomal recessive (rare)|autosomal recessive
ALDOB	autosomal recessive
PTS	autosomal recessive
RNF168	autosomal recessive
TEKT3	autosomal recessive
QDPR	autosomal recessive
DSTYK	autosomal dominant|autosomal recessive
WRAP53	autosomal recessive
RFX7	autosomal dominant
RFX6	autosomal recessive
TBC1D7	autosomal recessive
RSPH9	autosomal recessive
RSPH4A	autosomal recessive
ANK1	autosomal dominant, autosomal recessive
NDUFA11	autosomal recessive
UNC80	autosomal recessive
LMBRD1	autosomal recessive
SPNS2	autosomal recessive
FBN2	autosomal dominant
DNAAF2	autosomal recessive
DCAF17	autosomal recessive
ABCA5	autosomal recessive
COLEC11	autosomal recessive
ADSS1	autosomal recessive
RNF31	autosomal recessive
RNF43	autosomal dominant
AGXT2	autosomal recessive
ACTL6B	autosomal recessive|autosomal dominant
APOLD1	autosomal dominant
MEGF10	autosomal recessive
KANSL1	autosomal dominant
EYS	autosomal recessive
TMEM70	autosomal recessive
LRTOMT	autosomal recessive
FAT4	autosomal recessive
TLE6	autosomal recessive
CHKB	autosomal recessive
NDUFAF6	autosomal recessive
FECH	autosomal recessive
MED11	autosomal recessive
STING1	autosomal dominant
SLC29A3	autosomal recessive
NDUFAF5	autosomal recessive
KNG1	autosomal recessive|autosomal dominant
FOXI3	autosomal dominant, autosomal recessive
PAH	autosomal recessive
GGT1	autosomal recessive
CILK1	autosomal dominant|autosomal recessive
CCDC34	autosomal recessive
FASTKD2	autosomal recessive
ATAD3A	autosomal dominant, autosomal recessive (one family)|autosomal recessive
KRT6C	autosomal dominant
F5	? autosomal recessive|autosomal dominant|multifactorial predisposition|autosomal recessive
TRIM44	autosomal dominant
PROC	autosomal dominant|autosomal recessive
FUCA1	autosomal recessive
ADAMTSL2	autosomal recessive
YRDC	autosomal recessive
TTLL5	autosomal recessive
MAST3	autosomal dominant
MAST1	autosomal dominant
GPR161	somatic mutation, autosomal dominant, autosomal recessive
ADGRG6	autosomal recessive
GALNS	autosomal recessive
ZFP57	autosomal dominant (loss of maternal allele), autosomal recessive
DMXL2	autosomal dominant|autosomal recessive
NAT2	autosomal recessive
MYSM1	autosomal recessive
HSD17B13	autosomal dominant
PNPLA8	autosomal recessive
PNPLA1	autosomal recessive
CIDEC	autosomal recessive
SLC17A9	autosomal dominant
SLC51B	autosomal recessive
SLC51A	autosomal recessive
CIC	autosomal dominant
UQCRQ	autosomal recessive
ZNF469	autosomal recessive
RBM28	autosomal recessive
GET4	autosomal recessive
ZFP36L2	autosomal recessive
BEAN1	autosomal dominant
TMEM43	autosomal dominant
RNF212	autosomal recessive
PARS2	autosomal recessive
AARS2	autosomal recessive
APC2	autosomal recessive
FITM2	autosomal recessive
LARP7	autosomal recessive
IYD	autosomal recessive
OTUD7A	autosomal recessive
OTUD6B	autosomal recessive
TTC21B	autosomal dominant, autosomal recessive|autosomal recessive
CC2D2A	autosomal recessive
ZFYVE26	autosomal recessive
CREB3L3	autosomal dominant
MRPS34	autosomal recessive
MRPS28	autosomal recessive
MRPS25	autosomal recessive
MRPS23	autosomal recessive
MRPS14	autosomal recessive
MRPS7	autosomal recessive
MRPS2	autosomal recessive
TRAPPC9	autosomal recessive
C3orf52	autosomal recessive
B9D2	autosomal recessive
MMADHC	autosomal recessive
FAM83H	autosomal dominant
ISCU	autosomal recessive
SLC16A12	autosomal dominant
RFT1	autosomal recessive
VWA1	autosomal recessive
MIR140	autosomal dominant
PLEKHG2	autosomal recessive
ERF	autosomal dominant
SHARPIN	autosomal recessive
MRPL44	autosomal recessive
MRPL39	autosomal recessive
ELOVL1	autosomal dominant, autosomal recessive
ELOVL5	autosomal dominant
PGAP3	autosomal recessive
GPD1L	autosomal dominant
NDUFAF4	autosomal recessive
MTFMT	autosomal recessive
ASPRV1	autosomal dominant
LMF1	autosomal recessive
APC	autosomal dominant|somatic mutation, autosomal dominant|somatic mutation
KLC2	autosomal recessive
KCTD7	autosomal recessive
IRF2BPL	autosomal dominant
ATP6V0A2	autosomal recessive
SRD5A3	autosomal recessive
TTBK2	autosomal dominant
CLMP	autosomal recessive
KHDC3L	autosomal recessive
SLC46A1	autosomal recessive
TRMT1	autosomal recessive
TBC1D20	autosomal recessive
PGAP1	autosomal recessive
CSPP1	autosomal recessive
PPIP5K2	autosomal recessive
ARV1	autosomal recessive
HEPACAM	autosomal recessive|autosomal dominant
UBIAD1	autosomal dominant
NECAP1	autosomal recessive
SCAPER	autosomal recessive
PGM2L1	autosomal recessive
MIR96	autosomal dominant
ERLIN2	autosomal dominant|autosomal recessive
ERLIN1	autosomal recessive
TXNL4A	autosomal recessive
FARS2	autosomal recessive
KDM6B	autosomal dominant
SGMS2	autosomal dominant
FBP1	autosomal recessive
BLTP1	autosomal recessive
SEPTIN12	autosomal dominant
NALCN	autosomal dominant|autosomal recessive
ARSB	autosomal recessive
FOXD3	autosomal dominant
CTNNBL1	autosomal recessive
EMG1	autosomal recessive
RARS2	autosomal recessive
WLS	autosomal recessive
CENPT	autosomal recessive
CISD2	autosomal recessive
CAMTA1	autosomal dominant
GUSB	autosomal recessive
GATA5	autosomal dominant, autosomal recessive
CYP4F22	autosomal recessive
CA2	autosomal recessive
SYCE1	autosomal recessive
YIPF5	autosomal recessive
UFSP2	autosomal dominant|autosomal recessive
MBD5	autosomal dominant
PLEKHM1	autosomal recessive|autosomal dominant
SLC10A7	autosomal recessive
GLB1	autosomal recessive
BMS1	autosomal dominant
DOCK8	autosomal recessive
TTC21A	autosomal recessive
DONSON	autosomal recessive
CEP135	autosomal recessive
SRCAP	autosomal dominant
RIPOR2	autosomal recessive|autosomal dominant
OCA2	autosomal recessive at bey locus, eye color probably polygenic|autosomal recessive
LCA5	autosomal recessive
GAS2L2	autosomal recessive
ADNP	autosomal dominant
DIP2B	autosomal dominant
FANCI	autosomal recessive
TENT5A	autosomal recessive
INTS11	autosomal recessive
INTS8	autosomal recessive
INTS1	autosomal recessive
DNAJB11	autosomal dominant
DNAJB6	autosomal dominant
DNAJB4	autosomal recessive
MED12L	autosomal dominant
PIK3R5	autosomal recessive
KLHL24	autosomal recessive|autosomal dominant
DNMBP	autosomal recessive
KIF14	autosomal recessive
KIF12	autosomal recessive
NAPB	autosomal recessive
DOHH	autosomal recessive
TDRD7	autosomal recessive
KIF7	autosomal recessive
TMEM38B	autosomal recessive
SUCLG1	autosomal recessive
AKT3	autosomal dominant
UNC45B	autosomal dominant|autosomal recessive
UNC45A	autosomal recessive
RELT	autosomal recessive
CCDC88C	autosomal dominant|autosomal recessive
DNAJC5	autosomal dominant
ANKRD11	autosomal dominant
PIEZO1	autosomal recessive|autosomal dominant
IFT80	autosomal recessive
SAMD9L	autosomal dominant
XPA	autosomal recessive, with at least 4 loci
ATXN10	autosomal dominant
SLC30A7	autosomal recessive
SLC30A10	autosomal recessive
SLC30A8	autosomal dominant
TELO2	autosomal recessive
MFSD8	autosomal recessive
EPHA10	autosomal dominant
KLHL7	autosomal recessive|autosomal dominant
FGD4	autosomal recessive
ACAD9	autosomal recessive
PLEKHG5	autosomal recessive
MTMR14	autosomal dominant
CCDC65	autosomal recessive
DPH5	autosomal recessive
PPM1K	autosomal recessive
FAM20A	autosomal recessive
FAM20C	autosomal recessive
SETBP1	autosomal dominant
SETD1B	autosomal dominant
RUSC2	autosomal recessive
SETD1A	autosomal dominant
CCDC50	autosomal dominant
G6PC3	autosomal recessive
SLC25A26	autosomal recessive
SLC17A3	autosomal dominant
FA2H	autosomal recessive
TRMT5	autosomal recessive
ISCA1	autosomal recessive
OBSL1	autosomal recessive
LRRK1	autosomal recessive
INF2	autosomal dominant
TRAPPC4	autosomal recessive
TRAPPC2L	autosomal recessive
FTO	autosomal recessive
YARS2	autosomal recessive
DARS2	autosomal recessive
SYT14	autosomal recessive
MIR204	autosomal dominant
RPGRIP1L	autosomal recessive
PSAT1	autosomal recessive
NOBOX	autosomal dominant
LRSAM1	autosomal dominant, autosomal recessive
SOX17	autosomal dominant
IL17RC	autosomal recessive
RBCK1	autosomal recessive
RAB34	autosomal recessive
NSUN2	autosomal recessive
AMTN	autosomal dominant
ARHGAP31	autosomal dominant
SNF8	autosomal recessive
CHMP4B	autosomal dominant
KMT5B	autosomal dominant
HACE1	autosomal recessive
FLVCR2	autosomal recessive
GNB4	autosomal dominant
AGL	autosomal recessive
CARMIL2	autosomal recessive
ANKRD26	autosomal dominant
SPG11	autosomal recessive
NAA20	autosomal recessive
ZNF335	autosomal recessive
SLC25A46	autosomal recessive
SLC25A42	autosomal recessive
SLC25A38	autosomal recessive
HYDIN	autosomal recessive
SLC35D1	autosomal recessive
SLC41A1	autosomal recessive
SLC35B2	autosomal recessive
CNPY3	autosomal recessive
CHD5	autosomal dominant
MNS1	autosomal recessive
TSPOAP1	autosomal recessive
DOLK	autosomal recessive
STRA6	autosomal recessive
TNRC6B	autosomal dominant
TNRC6A	autosomal dominant
TTC12	autosomal recessive
HYLS1	autosomal recessive
HIBCH	autosomal recessive
BBS12	autosomal recessive
PFKM	autosomal recessive
NACC1	autosomal dominant
CYP2U1	autosomal recessive
PIGY	autosomal recessive
NGLY1	autosomal recessive
WASHC5	autosomal recessive|autosomal dominant
PDE10A	autosomal recessive|autosomal dominant
CUX2	autosomal dominant
NAT8L	autosomal recessive
A2ML1	autosomal dominant
ADPRS	autosomal recessive
FUZ	autosomal dominant
INTU	autosomal recessive
F12	autosomal dominant|autosomal recessive
CYP11B1	autosomal recessive|autosomal dominant
GINS1	autosomal recessive
FLAD1	autosomal recessive
FNIP1	autosomal recessive
RSPO2	autosomal recessive
RSPO4	autosomal recessive
MARVELD2	autosomal recessive
ZNF687	autosomal dominant
DNAL4	autosomal recessive
PDSS2	autosomal recessive
UFC1	autosomal recessive
UFM1	autosomal recessive
UBA5	autosomal recessive
MAT1A	autosomal dominant, autosomal recessive
GNAS-AS1	autosomal dominant
UBE2T	autosomal recessive
DCPS	autosomal recessive
HYCC1	autosomal recessive
CHD8	autosomal dominant
CEP41	autosomal recessive
GLYCTK	autosomal recessive
ATP13A2	autosomal recessive
SEC23B	autosomal dominant|autosomal recessive
SEC23A	autosomal recessive, autosomal dominant (in 1 family)
RTN4IP1	autosomal recessive
HACD1	autosomal recessive
GPR156	autosomal recessive
NUS1	autosomal recessive|autosomal dominant
SMPD4	autosomal recessive
SAMD9	autosomal dominant|autosomal recessive
HGSNAT	autosomal recessive
RTTN	autosomal recessive
RNF125	autosomal dominant
PACS2	autosomal dominant
TRAPPC6B	autosomal recessive
MPEG1	autosomal dominant
LAMTOR2	autosomal recessive
ACKR3	autosomal recessive
PADI6	autosomal recessive
RAX2	autosomal dominant|autosomal recessive
PALB2	autosomal dominant
RIC1	autosomal recessive
LINS1	autosomal recessive
SLF2	autosomal recessive
AGK	autosomal recessive
P3H2	autosomal recessive
P3H1	autosomal recessive
RNASEH2C	autosomal recessive
RNASEH2B	autosomal recessive
PNPT1	autosomal recessive|autosomal dominant
B3GLCT	autosomal recessive
MAFA	autosomal dominant
SLC6A17	autosomal recessive
DOK7	autosomal recessive
LIPT1	autosomal recessive
ORAI1	autosomal recessive|autosomal dominant
PIGW	autosomal recessive
PIGV	autosomal recessive
PIGM	autosomal recessive
PIGT	autosomal dominant, somatic mutation|autosomal recessive
PIGS	autosomal recessive
TAOK1	autosomal dominant
DNAJB13	autosomal recessive
SEC31A	autosomal recessive
ZFYVE27	autosomal dominant
LNPK	autosomal recessive
ATP13A3	autosomal recessive
TRMU	mitochondrial|autosomal recessive
SOHLH1	autosomal recessive|autosomal dominant
RIN2	autosomal recessive
PJVK	autosomal recessive
EDEM3	autosomal recessive
SLC4A11	autosomal recessive
MED25	autosomal recessive
B3GALNT2	autosomal recessive
GLIS3	autosomal recessive
KIAA0586	autosomal recessive
SPEF2	autosomal recessive
IQSEC1	autosomal recessive
CCDC28B	autosomal recessive, digenic recessive
CCT5	autosomal recessive
BBS10	autosomal recessive
CEP290	autosomal recessive
VANGL1	autosomal dominant
SLC26A1	autosomal recessive
CHST11	autosomal recessive
ADAMTSL4	autosomal recessive
ANO3	autosomal dominant
ANO1	autosomal recessive|autosomal dominant, autosomal recessive (in 1 patient)
OSGEP	autosomal recessive
MCM9	autosomal recessive
DEF6	autosomal recessive
RINT1	autosomal recessive
PRMT7	autosomal recessive
TENM4	autosomal dominant
TENM3	autosomal recessive
DNAH17	autosomal recessive
DNAL1	autosomal recessive
DNAH7	autosomal recessive
POLR1C	autosomal recessive
TECR	autosomal recessive
CC2D1A	autosomal recessive
TUBGCP6	autosomal recessive
ALDH5A1	autosomal recessive
KCNT2	autosomal dominant
CLDN19	autosomal recessive
VPS45	autosomal recessive
VPS33A	autosomal recessive
TNPO3	autosomal dominant
ARSK	autosomal recessive
ARSG	autosomal recessive
TNIK	autosomal recessive
COL25A1	autosomal recessive
CEP55	autosomal recessive
PPA2	autosomal recessive
VPS4A	autosomal dominant
GGN	autosomal recessive
RNF216	autosomal recessive
PRORP	autosomal recessive
CDCA7	autosomal recessive
VPS37A	autosomal recessive
KAT8	autosomal dominant
CFAP91	autosomal recessive
MYL9	autosomal recessive
KREMEN1	autosomal recessive
RIPPLY2	autosomal recessive
TMEM67	autosomal recessive
MKS1	autosomal recessive
ATOH7	autosomal recessive
SPATA7	autosomal recessive
TCTN1	autosomal recessive
TMPRSS6	autosomal recessive
SPATA16	autosomal recessive
COASY	autosomal recessive
PPCS	autosomal recessive
SI	autosomal recessive
EDC3	autosomal recessive
SLC24A4	autosomal recessive
MMACHC	autosomal recessive
SLC34A3	autosomal recessive
COQ2	autosomal dominant, autosomal recessive|autosomal recessive
HMBS	autosomal recessive|autosomal dominant
CFAP52	autosomal recessive
SLC24A5	autosomal recessive
NEK8	autosomal recessive
NEK9	autosomal recessive|somatic mutation
BICD2	autosomal dominant
LINGO1	autosomal recessive
UBAP1	autosomal dominant
SDR9C7	autosomal recessive
KDM4B	autosomal dominant
PI4K2A	autosomal recessive
BLOC1S3	autosomal recessive
TRIOBP	autosomal recessive
ACOX1	autosomal dominant|autosomal recessive
CADM3	autosomal dominant
ILDR1	autosomal recessive
CCDC88A	autosomal recessive
MARS2	autosomal recessive
PKD1L1	autosomal recessive
CRB2	autosomal recessive
PKLR	autosomal dominant|autosomal recessive
LPL	autosomal recessive, multiple alleles and compounds|autosomal dominant
PSMG2	autosomal recessive
NAGLU	autosomal dominant|autosomal recessive
HPD	autosomal dominant|autosomal recessive
FHOD3	autosomal dominant
FARSB	autosomal recessive
CEP250	autosomal recessive
DCLRE1B	autosomal recessive
SLITRK6	autosomal recessive
SLITRK1	autosomal dominant, multifactorial|autosomal dominant
STEAP3	autosomal dominant
NLRP7	autosomal recessive
NLRP5	autosomal recessive
NDUFAF2	autosomal recessive
NLRP12	autosomal dominant
FANCM	autosomal recessive
RIGI	autosomal dominant
SLC30A2	autosomal dominant
TUBGCP4	autosomal recessive
NECTIN4	autosomal recessive
RSPO1	autosomal recessive
RIT1	autosomal dominant
GLRX5	autosomal recessive
L2HGDH	autosomal recessive
CUL7	autosomal recessive
ACADVL	autosomal recessive
ZNF699	autosomal recessive
CPA6	autosomal dominant, autosomal recessive (in 1 patient)|autosomal recessive
PREPL	autosomal recessive
LMAN2L	autosomal dominant|autosomal recessive
ARID2	autosomal dominant
RAPGEF2	autosomal dominant
ALDH3A2	autosomal recessive
THAP1	autosomal dominant
TAF8	autosomal recessive
CHMP2B	autosomal dominant
IL31RA	autosomal dominant
TOPORS	autosomal dominant
CYP27B1	autosomal recessive
CDHR1	autosomal recessive
MANBA	autosomal recessive
MAP3K20	autosomal recessive
GBA2	autosomal recessive
MAN2B1	autosomal recessive
HAL	autosomal recessive, autosomal dominant
NDE1	autosomal recessive
CELA2A	autosomal dominant
NDUFA13	autosomal recessive
LHFPL5	autosomal recessive
RC3H1	autosomal recessive
PIKFYVE	autosomal dominant
ERCC6	autosomal recessive|somatic mutation, autosomal dominant|autosomal dominant
ERCC8	autosomal recessive
STOX1	autosomal dominant
FIG4	autosomal recessive|autosomal dominant
SMC5	autosomal recessive
NIPAL4	autosomal recessive
IER3IP1	autosomal recessive
ACD	autosomal dominant, autosomal recessive
KDM3B	autosomal dominant
ATL3	autosomal dominant
KIFBP	autosomal recessive
NLRP2	autosomal recessive
MCM10	autosomal recessive
ESCO2	autosomal recessive
REEP2	autosomal recessive|autosomal dominant
REEP6	autosomal recessive
CBLIF	autosomal recessive
TTC7A	autosomal recessive
SASS6	autosomal recessive
TRIM36	autosomal recessive
RSPH1	autosomal recessive
DBH	autosomal recessive
MSH2	autosomal dominant|autosomal recessive
SLC25A22	autosomal recessive
PERP	autosomal recessive|autosomal dominant
CYP17A1	autosomal recessive
SPRED2	autosomal recessive
SPRED1	autosomal dominant
EIF2AK4	autosomal recessive
CENPJ	autosomal recessive
NCAPD3	autosomal recessive
RAB3GAP2	autosomal recessive
NUP37	autosomal recessive
CRBN	autosomal recessive
RNF13	autosomal dominant
GPSM2	autosomal recessive
LPAR6	autosomal recessive
IQCB1	autosomal recessive
WDR45B	autosomal recessive
WIPI2	autosomal recessive
SEC61A1	autosomal dominant
IVNS1ABP	autosomal dominant
MRPS16	autosomal recessive
MRAP	autosomal recessive
MPLKIP	autosomal recessive
SUGCT	autosomal recessive
D2HGDH	autosomal recessive
KNL1	autosomal recessive
SGO1	autosomal recessive
NFASC	autosomal recessive
FLVCR1	autosomal recessive
REEP1	autosomal dominant|autosomal recessive
KDM1A	autosomal dominant
ATP9A	autosomal recessive
PDCD10	autosomal dominant
FBXO43	autosomal recessive
FBXO31	autosomal recessive
FBXO28	autosomal dominant
TXN2	autosomal recessive
POU6F2	autosomal dominant, somatic mutation
PNPLA2	autosomal recessive
MMUT	autosomal recessive
CARD8	autosomal dominant
KDELR2	autosomal recessive
PNKD	autosomal dominant
BTD	autosomal recessive
HLCS	autosomal recessive
MCCC2	autosomal recessive
MCCC1	autosomal recessive
LRRK2	autosomal dominant
ADAMTS10	autosomal recessive
RNF2	autosomal dominant
DNAJC19	autosomal recessive
MAFB	autosomal dominant
CABP4	autosomal recessive
TRPM3	autosomal dominant
ADA	autosomal recessive, somatic mosaicism
FREM2	autosomal recessive
FREM1	autosomal recessive|autosomal dominant
ARL13B	autosomal recessive
PITPNM3	autosomal dominant
ATPAF2	autosomal recessive
UNC13D	autosomal recessive
SGCG	autosomal recessive
AHI1	autosomal recessive
SLC6A19	autosomal recessive
CHD7	autosomal dominant
RALGAPA1	autosomal recessive
VPS13C	autosomal recessive
VPS13D	autosomal recessive
SEMA6B	autosomal dominant
LRIG2	autosomal recessive
FRA10AC1	autosomal recessive
NAXE	autosomal recessive
ASTL	autosomal recessive
CPT1C	autosomal dominant
ARL6	autosomal recessive, digenic recessive|autosomal recessive
CPAMD8	autosomal recessive
RTEL1	autosomal dominant, autosomal recessive|autosomal dominant
GREM2	autosomal dominant
RDH12	autosomal dominant (in one rp53 family), autosomal recessive
EFHC1	autosomal dominant
GJC2	autosomal recessive|autosomal dominant
GCDH	autosomal recessive
GSDME	autosomal dominant
MEI1	autosomal recessive
GIPC3	autosomal recessive
PC	autosomal recessive
GTF2H5	autosomal recessive
KLHL10	autosomal dominant
MED13L	autosomal dominant
DLAT	autosomal recessive
PDHX	autosomal recessive
SLC5A7	autosomal recessive|autosomal dominant
ATG7	autosomal recessive
CLP1	autosomal recessive
TSEN15	autosomal recessive
TSEN54	autosomal recessive
TSEN34	autosomal recessive
TSEN2	autosomal recessive
C1QTNF5	autosomal dominant
ALG3	autosomal recessive
BRD4	autosomal dominant
SLC25A24	autosomal dominant
ERI1	autosomal recessive
SLC39A14	autosomal dominant|autosomal recessive
SLC39A13	autosomal recessive
SLC39A8	autosomal recessive
SLC39A5	autosomal dominant
PHACTR1	autosomal dominant
CYP2R1	autosomal recessive
CDON	autosomal dominant
DNAAF4	autosomal dominant|autosomal recessive
NMNAT1	autosomal recessive
BMPER	autosomal recessive
FIGLA	autosomal dominant, autosomal recessive
NIN	autosomal recessive
TPRKB	autosomal recessive
TP53RK	autosomal recessive
MIB1	autosomal dominant
FCSK	autosomal recessive
DZIP1	autosomal dominant|autosomal recessive
BNC2	autosomal dominant
ZMYND11	autosomal dominant
NIPBL	autosomal dominant
PEX26	autosomal recessive
PSMC3IP	autosomal recessive
ANO6	autosomal recessive
ANO5	autosomal dominant|autosomal recessive
SEC63	autosomal dominant
ROBO3	autosomal recessive
TBL1XR1	autosomal dominant
STRADA	autosomal recessive
PTRH2	autosomal recessive
OBSCN	autosomal recessive
CYP4V2	autosomal recessive
SP6	autosomal dominant
STT3B	autosomal recessive
GLDN	autosomal recessive
CFHR5	autosomal dominant
RP1L1	autosomal dominant|autosomal recessive
GRHL2	autosomal dominant|autosomal recessive
MYH14	autosomal dominant
STAB1	autosomal recessive
MTX2	autosomal recessive
VPS33B	autosomal recessive
VPS16	autosomal dominant
VPS11	autosomal recessive
HMCN1	autosomal dominant
VKORC1	autosomal recessive|autosomal dominant
EIF4A3	autosomal recessive
GLIS2	autosomal recessive
VHL	autosomal recessive|autosomal dominant
GTPBP3	autosomal recessive
FBXO38	autosomal dominant
NCAPG2	autosomal recessive
PIGU	autosomal recessive
MYPN	autosomal dominant|autosomal recessive
NCF2	autosomal recessive
NCF1	autosomal recessive
CYBA	autosomal recessive
MFN2	autosomal dominant|autosomal recessive
PRICKLE1	autosomal recessive
ZPBP	autosomal recessive
STAG3	autosomal recessive
SMOC1	autosomal recessive
SLC26A8	autosomal dominant, autosomal recessive
ANAPC1	autosomal recessive
SETX	autosomal dominant|autosomal recessive
COL27A1	autosomal recessive
NCDN	autosomal dominant
PYGM	autosomal recessive
ETHE1	autosomal recessive
KMT2E	autosomal dominant
SYNE2	autosomal dominant
SYNE1	autosomal recessive|autosomal dominant
TLK2	autosomal dominant
MRAS	autosomal dominant
ZBTB18	autosomal dominant
CHST14	autosomal recessive
CYP26C1	autosomal recessive
PANX1	autosomal dominant
MCEE	autosomal recessive
MMP21	autosomal recessive
PLCE1	autosomal recessive
USH2A	autosomal recessive
DPYSL5	autosomal dominant
CERKL	autosomal recessive
NEMF	autosomal recessive
DNAJC6	autosomal recessive
HJV	autosomal recessive
SCD5	autosomal dominant
LRRC8A	autosomal dominant
BCKDHA	autosomal recessive
DCXR	autosomal recessive
SLC36A2	autosomal dominant|autosomal recessive, digenic recessive
MYRF	autosomal dominant
PHF21A	autosomal dominant
GRHL3	autosomal dominant
ARG1	autosomal recessive
ASL	autosomal recessive
PINK1	autosomal recessive
CPS1	autosomal recessive
SLC13A5	autosomal recessive
LGI4	autosomal recessive
LGI3	autosomal recessive
NAGS	autosomal recessive
FIBP	autosomal recessive
IGF2BP2	autosomal dominant
NADSYN1	autosomal recessive
KIF21A	autosomal dominant
NEU1	autosomal recessive
MACF1	autosomal dominant
TASP1	autosomal recessive
RRAGD	autosomal dominant
RRAGC	autosomal dominant
DPP9	autosomal recessive
SCN4B	autosomal dominant
KRT74	autosomal recessive|autosomal dominant
KRT71	autosomal dominant
NSMCE3	autosomal recessive
SNIP1	autosomal recessive
SPPL2A	autosomal recessive
CACNA1I	autosomal dominant
NANOS1	autosomal dominant
ADSL	autosomal recessive
SCN3B	autosomal dominant
EXT2	autosomal dominant|autosomal recessive
SH3TC2	autosomal recessive|autosomal dominant
MECR	autosomal recessive
UNC93B1	autosomal recessive
CDK5RAP2	autosomal recessive
CRLS1	autosomal recessive
MCM8	autosomal recessive
CHSY1	autosomal recessive
SPG21	autosomal recessive
ATCAY	autosomal recessive
EXT1	somatic mutation|autosomal dominant
DHDDS	autosomal recessive|autosomal dominant
CACNA2D4	autosomal recessive
DDX41	autosomal dominant
KCNT1	autosomal dominant
EXOC7	autosomal recessive
SOX9	autosomal dominant
WDR19	autosomal recessive
SATB2	autosomal dominant
NIPA1	autosomal dominant
HSCB	autosomal recessive
NSMF	autosomal dominant
ARHGEF10	autosomal dominant
ASPN	autosomal dominant
TTC8	autosomal recessive
NUAK2	autosomal recessive
XYLT2	autosomal recessive
XYLT1	autosomal recessive
TRAK1	autosomal recessive
FANCL	autosomal recessive
PUS1	autosomal recessive
MEFV	autosomal dominant|autosomal recessive
ALG8	autosomal recessive|autosomal dominant
CLN5	autosomal recessive
NFU1	autosomal recessive
SCNM1	autosomal recessive
PALLD	autosomal dominant
GIMAP5	autosomal recessive
APOC2	autosomal recessive
PLCZ1	autosomal recessive
PDCD6IP	autosomal recessive
NHLRC1	autosomal recessive
HES7	autosomal recessive
ETFA	autosomal recessive
UBE3B	autosomal recessive
ANTXR2	autosomal recessive
IFT74	autosomal recessive
ASPA	autosomal recessive
NBAS	autosomal recessive
HSPB8	autosomal dominant
LMOD2	autosomal recessive
SIL1	autosomal recessive
NPHP3	autosomal recessive
NAA15	autosomal dominant
ASH1L	autosomal dominant
TPP1	autosomal recessive
SPRY4	autosomal dominant (see miscellaneous below)
GORAB	autosomal recessive
SCYL1	autosomal recessive
TOMM7	autosomal recessive
COX4I2	autosomal recessive
BBS9	autosomal recessive
SEMA7A	autosomal recessive
SASH1	autosomal recessive|autosomal dominant
CEP57	autosomal recessive
SUMF1	autosomal recessive
CCM2	autosomal dominant
WHRN	autosomal recessive
SELENOI	autosomal recessive
LIMS2	autosomal recessive
ALG2	autosomal recessive
CACNA1H	autosomal dominant
FERMT3	autosomal recessive
FERMT1	autosomal recessive
DSG4	autosomal recessive
SLC52A1	autosomal dominant
SLC52A2	autosomal recessive
EXOC6B	autosomal recessive
NNT	autosomal recessive
INPP5K	autosomal recessive
FBXO11	autosomal dominant
RCBTB1	autosomal recessive
DACT1	autosomal dominant
YY1AP1	autosomal recessive
BEST1	autosomal dominant
RDH11	autosomal recessive
LEMD3	autosomal dominant
PKHD1L1	autosomal recessive
GNPTAB	autosomal recessive
GBE1	autosomal recessive
GNPTG	autosomal recessive
CLN8	autosomal recessive
FRAS1	autosomal recessive
VPS13B	autosomal recessive
RGS9BP	autosomal recessive
ACAT1	autosomal recessive
CNNM4	autosomal recessive
CNNM2	autosomal dominant|autosomal dominant, autosomal recessive (1 family)
ABCA12	autosomal recessive
PRPF4	autosomal dominant
PCSK9	autosomal dominant
MESD	autosomal recessive
SIN3A	autosomal dominant
HSD3B7	autosomal recessive
ITGA2B	autosomal dominant|autosomal recessive
CCNO	autosomal recessive
TAS2R38	autosomal dominant, possibly two loci involved
TJP2	autosomal recessive
CAMK2B	autosomal dominant
KLHL41	autosomal recessive
SBF2	autosomal recessive
USH1G	autosomal recessive
SECISBP2	autosomal recessive
SAR1B	autosomal recessive
CLCF1	autosomal recessive
ARL6IP1	autosomal recessive
CTNNA3	autosomal dominant
GNS	autosomal recessive
CTH	autosomal recessive
STK36	autosomal recessive
OSTM1	autosomal recessive
PLVAP	autosomal recessive
RAI1	autosomal dominant, isolated cases
ATXN7	autosomal dominant
XDH	autosomal recessive
PSENEN	autosomal dominant
NPC1	autosomal recessive
PMVK	autosomal dominant
COLEC10	autosomal recessive
NUP107	autosomal recessive
NUP160	autosomal recessive
NUP133	autosomal recessive
SMPD1	autosomal recessive
NUP54	autosomal recessive
KRT9	autosomal dominant
KCNV2	autosomal recessive
TICAM1	autosomal dominant, autosomal recessive
BBS7	autosomal recessive
ATM	autosomal dominant, somatic mutation|autosomal recessive
ADA2	autosomal recessive
ARSA	autosomal recessive
SLC25A21	autosomal recessive
MMAB	autosomal recessive
EPM2A	autosomal recessive
ARHGEF2	autosomal recessive
SLC17A8	autosomal dominant
TWIST2	autosomal dominant|autosomal recessive
MSMO1	autosomal recessive
LRPPRC	autosomal recessive
KCNQ1	autosomal dominant|autosomal recessive
PIBF1	autosomal recessive
SARS1	autosomal recessive
ROBO4	autosomal dominant
RPL27	autosomal dominant
HPS6	autosomal recessive
HPS5	autosomal recessive
ADAMTS19	autosomal recessive
ADAMTS18	autosomal recessive
ADAMTS17	autosomal recessive
ADAMTS15	autosomal recessive
PACS1	autosomal dominant
POFUT1	autosomal dominant
LDHD	autosomal recessive
MMAA	autosomal recessive
APCDD1	autosomal dominant
HGD	autosomal recessive
YME1L1	autosomal recessive
BCAS3	autosomal recessive
GPR88	autosomal recessive
CDAN1	autosomal recessive
PPP1R13L	autosomal recessive
ATN1	autosomal dominant
DYM	autosomal recessive
SBDS	autosomal recessive
FKTN	autosomal recessive
POMT2	autosomal recessive
ERAL1	autosomal recessive
GTPBP2	autosomal recessive
PDSS1	autosomal recessive
KIRREL1	autosomal recessive
POMT1	autosomal recessive
NME8	autosomal recessive
DAOA	autosomal dominant
EBF3	autosomal dominant
MC2R	autosomal recessive
CDC73	autosomal dominant
IFT172	autosomal recessive
TIMM50	autosomal recessive
TRAF3IP1	autosomal recessive
NF2	autosomal dominant
LIPH	autosomal recessive
AIRE	autosomal recessive, autosomal dominant
KCNQ5	autosomal dominant
RHOBTB2	autosomal dominant
ALPK1	autosomal dominant
SALL4	autosomal dominant
GABBR2	genetic factors seem to contribute only in light smokers and heavy smokers|autosomal dominant
RP9	autosomal dominant
CABP2	autosomal recessive
PGR	autosomal recessive
FILIP1	autosomal recessive
SRD5A2	autosomal recessive
PRPF3	autosomal dominant
PRPF8	autosomal dominant
MYO18B	autosomal recessive
CLIC5	autosomal recessive
SEMA4A	autosomal recessive
BLOC1S5	autosomal recessive
FLCN	autosomal dominant|somatic mutation, autosomal dominant
AUTS2	autosomal dominant
EVC2	autosomal recessive|autosomal dominant
SOX6	autosomal dominant
APOL4	autosomal dominant
APOL2	autosomal dominant
TIMM22	autosomal recessive
AP3D1	autosomal recessive
AP4B1	autosomal recessive
AP4E1	autosomal recessive|autosomal dominant
AP4S1	autosomal recessive
TMIE	autosomal recessive
SMOC2	autosomal recessive
NPHP4	autosomal recessive
ORC6	autosomal recessive
CARD9	autosomal recessive
CARD14	autosomal dominant
CARD11	autosomal dominant|autosomal recessive
CARD10	autosomal recessive
STUB1	autosomal dominant|autosomal recessive
ALOXE3	autosomal recessive
PUM1	autosomal dominant
HNRNPR	autosomal dominant
IRF6	autosomal dominant
TDP1	autosomal recessive
PTF1A	autosomal recessive
SEC24D	autosomal recessive
FYCO1	autosomal recessive
RBM12	autosomal dominant
CRELD1	autosomal dominant|autosomal recessive
TSGA10	autosomal recessive
LOXL3	autosomal recessive
ZMIZ1	autosomal dominant
DTNBP1	autosomal recessive
ALG12	autosomal recessive
FANCA	autosomal recessive
HNRNPDL	autosomal dominant
PROKR2	autosomal dominant
PLCB1	autosomal recessive
MRPL3	autosomal recessive
MCPH1	autosomal recessive
SPART	autosomal recessive
PAX6	autosomal dominant, ? same as 120200|autosomal dominant
WT1	autosomal dominant, somatic mutation|autosomal dominant|somatic mutation
NPHP1	autosomal recessive
SLC22A12	autosomal recessive
MTHFR	? autosomal recessive|autosomal dominant|autosomal recessive
CACNA2D2	autosomal recessive
NAA80	autosomal recessive
NPRL2	autosomal dominant
HYAL1	autosomal recessive
ZMYND10	autosomal recessive
TRPV3	autosomal dominant
FKBP10	autosomal recessive
SLC39A4	autosomal recessive
USP18	autosomal recessive
IMPG2	autosomal dominant|autosomal recessive
ATXN3	autosomal dominant, multifactorial|autosomal dominant
TRAF3IP2	autosomal recessive
CLN3	autosomal recessive
ABCC11	autosomal dominant
OTOA	autosomal recessive
EHHADH	autosomal dominant
IVD	autosomal recessive
SUFU	somatic mutation, autosomal dominant, autosomal recessive|autosomal dominant|autosomal recessive
LIAS	autosomal recessive
ATP6V1A	autosomal recessive|autosomal dominant
DBR1	autosomal recessive
BDP1	autosomal recessive
TRPM6	autosomal recessive
ACADM	autosomal recessive
GEMIN5	autosomal recessive
PROK2	autosomal dominant
EHMT1	autosomal dominant
GALT	autosomal recessive
COPB2	autosomal recessive|autosomal dominant
MPO	autosomal dominant|autosomal recessive
CHP1	autosomal recessive
ELP4	autosomal dominant
GGPS1	autosomal recessive
COQ8A	autosomal recessive
COG7	autosomal recessive
COG6	autosomal recessive
COG4	autosomal recessive|autosomal dominant
COG3	autosomal recessive
COG2	autosomal recessive
COG1	autosomal recessive
GEMIN4	autosomal recessive
LCAT	autosomal recessive
WBP2	autosomal recessive
GALE	autosomal recessive
IFIH1	autosomal dominant|autosomal recessive
ANAPC7	autosomal recessive
LDLR	autosomal dominant, autosomal recessive
ALG9	autosomal recessive
ZFHX4	autosomal dominant
ATP6V1B2	autosomal dominant
UROS	autosomal recessive
TRPM4	autosomal dominant
NDUFAF1	autosomal recessive
TYR	autosomal dominant|autosomal recessive
THOC1	autosomal dominant
OXGR1	autosomal dominant
CERS1	autosomal recessive
MRM2	autosomal recessive
LYST	autosomal recessive
GALC	autosomal recessive
SUOX	autosomal recessive
ACADS	autosomal recessive
IRAK4	autosomal recessive
ATP7B	autosomal recessive
PHGDH	autosomal recessive
HEXB	autosomal recessive with multiple alleles and compounds
JAM3	autosomal recessive
JAM2	autosomal recessive
HEXA	autosomal recessive
SERPING1	autosomal dominant, autosomal recessive (in some patients)|autosomal dominant
GCLC	autosomal recessive
TCOF1	autosomal dominant
ALMS1	autosomal recessive
RB1CC1	autosomal dominant, somatic mutation
KMT2B	autosomal dominant
KMT2C	autosomal dominant
NLRC4	autosomal dominant
AGTPBP1	autosomal recessive
FXN	autosomal recessive
POMGNT1	autosomal recessive
COG5	autosomal recessive
ALDH4A1	autosomal recessive
PRODH	autosomal dominant (22q11)|autosomal recessive
MYO3A	autosomal dominant|autosomal recessive
IL17RD	autosomal dominant (see miscellaneous below), autosomal recessive, digenic dominant
FTCD	autosomal recessive
GAA	autosomal recessive
ST14	autosomal recessive
SLC25A10	autosomal recessive
TKT	autosomal recessive
TPO	autosomal recessive
MLYCD	autosomal recessive
DUOX2	autosomal recessive
PADI3	autosomal recessive
SAMHD1	autosomal dominant|autosomal recessive
VEZF1	autosomal dominant
TLL1	autosomal dominant
OSBPL2	autosomal dominant
SLC12A5	autosomal dominant|autosomal recessive
CLN6	autosomal recessive
MAPKAPK5	autosomal recessive
SLC26A2	autosomal recessive
PRSS12	autosomal recessive
TMC1	autosomal dominant|autosomal recessive
PKHD1	autosomal recessive
NUP155	autosomal recessive
TRAF7	autosomal dominant
EIF2B4	autosomal recessive
EIF2B1	autosomal recessive
HPS4	autosomal recessive
NSD1	autosomal dominant
TRPV6	autosomal recessive
UPB1	autosomal recessive
GP1BA	autosomal recessive|autosomal dominant
LGR4	autosomal dominant
HAVCR2	autosomal recessive
GFM1	autosomal recessive
NLRP1	autosomal recessive|autosomal dominant, autosomal recessive|autosomal dominant
TMPRSS15	autosomal recessive
SP7	autosomal recessive
RIMS2	autosomal recessive
GNMT	autosomal recessive
DAAM2	autosomal recessive
SMARCAL1	autosomal recessive
IFT57	autosomal recessive
TREX1	autosomal dominant|autosomal recessive, autosomal dominant
YAP1	autosomal dominant
EDARADD	autosomal dominant|autosomal recessive
GDAP1	autosomal recessive, autosomal dominant|autosomal recessive
PAX3	autosomal dominant|somatic mutation|autosomal dominant, autosomal recessive
FKRP	autosomal recessive
ENAM	autosomal dominant|autosomal recessive
PTPN23	autosomal recessive
DLL1	autosomal dominant
OPA3	autosomal recessive|autosomal dominant
SFRP4	autosomal recessive
LZTFL1	autosomal recessive
MYLK2	autosomal dominant, digenic dominant (see miscellaneous)
BCL11B	autosomal dominant
BCL11A	autosomal dominant
LZTS1	somatic mutation, autosomal dominant
GFM2	autosomal recessive
HDAC9	autosomal dominant
MYO5B	autosomal recessive
SCGB3A2	autosomal dominant vs. multifactorial
CYP27A1	autosomal recessive
MLPH	autosomal recessive
SRGAP1	autosomal dominant, somatic mutation
GDF3	autosomal dominant
SLC25A19	autosomal recessive
MPIG6B	autosomal recessive
ST3GAL3	autosomal recessive
EXOSC1	autosomal recessive
EXOSC5	autosomal recessive
EXOSC3	autosomal recessive
ZMPSTE24	autosomal recessive
POT1	autosomal recessive|autosomal dominant
CD320	autosomal recessive
NOP10	autosomal recessive|autosomal dominant
NHP2	autosomal recessive
HAMP	autosomal recessive
GBA1	autosomal dominant|autosomal dominant, multifactorial|autosomal recessive
RAD21	autosomal recessive|autosomal dominant
EIF2B2	autosomal recessive
LRBA	autosomal recessive
TXNRD2	autosomal recessive
HTRA2	autosomal recessive
STRC	autosomal recessive
ATL1	autosomal dominant
EGLN1	autosomal dominant
ELMO2	autosomal recessive
PRPF31	autosomal dominant
DHCR24	autosomal recessive
WDR11	autosomal dominant|autosomal recessive
NLRP3	autosomal dominant
BSND	autosomal recessive
SLC13A3	autosomal recessive
ANTXR1	autosomal dominant|autosomal recessive
ITCH	autosomal recessive
CLRN1	autosomal recessive
CATSPER1	autosomal recessive
NEDD4L	autosomal dominant
MAGI2	autosomal recessive
B3GAT3	autosomal recessive
FMN2	autosomal recessive
TPK1	autosomal recessive
APOA5	autosomal dominant
ACP4	autosomal recessive
AGR2	autosomal recessive
ALS2	autosomal recessive
ESPN	autosomal recessive
APTX	autosomal recessive
PSTPIP1	autosomal dominant
SIX6	autosomal recessive
CYFIP2	autosomal dominant
PCDHGC4	autosomal recessive
FBXW7	autosomal dominant
EIF2B3	autosomal recessive
CTNS	autosomal recessive
DISC2	autosomal dominant
TNFRSF13C	autosomal recessive
WNT10A	autosomal recessive|autosomal dominant, autosomal recessive
CLEC7A	autosomal recessive
STAMBP	autosomal recessive
SUZ12	autosomal dominant
DICER1	somatic mosaicism|autosomal dominant
IKZF5	autosomal dominant
SHANK3	autosomal dominant
AGO2	autosomal dominant
AGO1	autosomal dominant
MFRP	autosomal recessive
NT5C3A	autosomal recessive, probable heterogeneity
IKZF3	autosomal dominant
SPTBN4	autosomal recessive
SELENON	autosomal recessive
SLC28A1	autosomal recessive
SLC45A2	autosomal recessive at gey locus, eye color probably polygenic|autosomal recessive
WFS1	autosomal dominant|autosomal recessive
BHLHE41	autosomal dominant
IRX5	autosomal recessive
EXOSC9	autosomal recessive
PANK4	autosomal dominant
BSCL2	autosomal recessive|autosomal dominant
PANK2	autosomal recessive
ATP5F1E	autosomal recessive
SLC19A3	autosomal recessive
BBS2	autosomal recessive
SLC2A10	autosomal recessive
RAB23	autosomal recessive
SLC2A9	autosomal dominant, autosomal recessive
MYOCD	autosomal dominant
TRIM8	autosomal dominant
SLURP1	autosomal recessive
HPS3	autosomal recessive
SLC44A4	autosomal dominant
SLC44A1	autosomal recessive
PIP5K1C	autosomal recessive
ADGRE2	autosomal dominant
PIGN	autosomal recessive
MRTFA	autosomal recessive
TWNK	autosomal recessive|autosomal dominant
SMC3	autosomal dominant
DNAJC12	autosomal recessive
MBOAT7	autosomal recessive
IFT122	autosomal recessive
CD96	autosomal dominant
ARNT2	autosomal recessive
RNASEH2A	autosomal recessive
SRRM2	autosomal dominant
CPSF3	autosomal recessive
CPSF1	autosomal dominant
ZBTB20	autosomal dominant
EXOSC8	autosomal recessive
ALX3	autosomal recessive
POLR3K	autosomal recessive
BTNL2	autosomal dominant
HAX1	autosomal recessive
KIF1B	autosomal dominant, somatic mutation|autosomal dominant
PDP1	autosomal recessive
DCLRE1C	autosomal recessive
EED	autosomal dominant
PPP2R1A	autosomal dominant
UBR1	autosomal recessive
VPS13A	autosomal recessive
TRAIP	autosomal recessive
NOD2	multifactorial|autosomal dominant
NKX6-2	autosomal recessive
DPM3	autosomal recessive
RAB33B	autosomal recessive
GPRC5B	autosomal dominant
PIGL	autosomal recessive
DSE	autosomal recessive
PIGP	autosomal recessive
PCNT	autosomal recessive
WDR4	autosomal recessive
STIM1	autosomal recessive|autosomal dominant
ANGPTL4	autosomal dominant
MLC1	autosomal recessive
ALG1	autosomal recessive
LDB3	autosomal dominant
ECEL1	autosomal recessive
DNAH10	autosomal recessive
BRIP1	autosomal dominant, somatic mutation
SLC35C1	autosomal recessive
KAT6B	autosomal dominant
KCNN2	autosomal dominant
ZBTB7A	autosomal dominant
ATP8A2	autosomal recessive
ATP11A	autosomal dominant
RXYLT1	autosomal recessive
DMGDH	autosomal recessive
CASP14	autosomal recessive
HERC2	autosomal recessive at bey locus, eye color probably polygenic|autosomal recessive
TMC8	autosomal recessive
TMC6	autosomal recessive
POPDC3	autosomal recessive
NUP62	autosomal recessive
MRPS22	autosomal recessive
ZEB2	autosomal dominant
AMN	autosomal recessive
TEX15	autosomal recessive
MOV10L1	autosomal recessive
TEX14	autosomal recessive
MAPRE2	autosomal dominant
KLHL3	autosomal dominant, autosomal recessive
TDP2	autosomal recessive
SLC45A1	autosomal recessive
DCDC2	autosomal recessive
PIGQ	autosomal recessive
SPINK2	autosomal recessive
HID1	autosomal recessive
BCO1	autosomal dominant
LDLRAP1	autosomal recessive
EXTL3	autosomal recessive
HHAT	autosomal recessive
TUBA8	autosomal dominant
SOST	autosomal dominant|autosomal recessive
KY	autosomal recessive
PRX	autosomal recessive|autosomal dominant, autosomal recessive
KCNJ16	autosomal recessive
KCNK4	autosomal dominant
ICOSLG	autosomal recessive
KCNH5	autosomal dominant
SPTLC2	autosomal dominant
SPTLC1	autosomal dominant
RIPK4	autosomal recessive
SIK1	autosomal dominant
VAPB	autosomal dominant
TRPM7	autosomal dominant
BICRA	autosomal dominant
ACSL5	autosomal recessive
BTG4	autosomal recessive
KIF20A	autosomal recessive
FBXL4	autosomal recessive
FBXL3	autosomal recessive
FBXW11	autosomal dominant
FBXO7	autosomal recessive
SLC26A4	autosomal recessive
SLC35A1	autosomal recessive
SLC35A3	autosomal recessive
CIT	autosomal recessive
PCDH12	autosomal recessive
PNKP	autosomal recessive
OXR1	autosomal recessive
CLDN14	autosomal recessive
MYOZ2	autosomal dominant
IPO8	autosomal recessive
FOXL2	autosomal dominant, autosomal recessive (less common)|autosomal dominant
SF3B4	autosomal dominant
SF3B2	autosomal dominant
CDC40	autosomal recessive
DHX38	autosomal recessive
RASGRP2	autosomal recessive
HSD17B3	autosomal recessive
RTN4R	autosomal dominant
RETN	autosomal dominant
CIB2	autosomal recessive
FGF20	autosomal recessive
PRDM16	autosomal dominant
SLC4A10	autosomal recessive
AIP	autosomal dominant, somatic mutation
CD244	unproved inheritance
NOS1AP	autosomal recessive
GP6	autosomal recessive
ATF6	autosomal recessive
CDT1	autosomal recessive
LMBR1	autosomal recessive|autosomal dominant
LPIN1	autosomal recessive
B4GAT1	autosomal recessive
CDH23	autosomal dominant|autosomal recessive|autosomal recessive, digenic recessive
FOXP1	autosomal dominant
PCDH15	autosomal recessive|autosomal recessive, digenic recessive
ELOVL4	autosomal recessive|autosomal dominant
TMPRSS3	autosomal recessive
IL37	autosomal recessive
IL36RN	autosomal recessive
CRTAP	autosomal recessive
SLCO1B3	digenic recessive
LONP1	autosomal recessive
IFT81	autosomal recessive
VPS41	autosomal recessive
DNAI2	autosomal recessive
ASPM	autosomal recessive
IL17RA	autosomal recessive
ABCG8	autosomal recessive
ABCG5	autosomal recessive
BET1	autosomal recessive
ABCB6	autosomal dominant
RPGRIP1	autosomal recessive
ADIPOQ	autosomal dominant
PRKCH	multifactorial predisposition
PRKD1	autosomal dominant
MAPK8IP3	autosomal dominant
TRPV4	autosomal dominant
GJB4	autosomal dominant
DHH	autosomal recessive
ALX4	autosomal dominant|autosomal recessive
ABCA7	autosomal dominant
KCND3	autosomal dominant
BACH2	autosomal dominant
KDM5B	autosomal recessive
MINPP1	autosomal dominant, somatic mutation|autosomal recessive
IL21	autosomal recessive
IL21R	autosomal recessive
FGF23	autosomal dominant|autosomal recessive
GAN	autosomal recessive
AAAS	autosomal recessive
DMPK	autosomal dominant
ARFGEF2	autosomal recessive
ARHGAP26	autosomal dominant, somatic mutation
ELAC2	autosomal recessive
GAD1	autosomal recessive
YWHAG	autosomal dominant
GHRL	autosomal dominant, autosomal recessive, multifactorial
CFHR3	autosomal recessive, autosomal dominant|autosomal dominant
CYP3A5	multifactorial
FOXP2	autosomal dominant
HDAC4	autosomal dominant
RBM8A	autosomal recessive
GDF15	autosomal dominant
CHST6	autosomal recessive
OPA1	autosomal recessive|autosomal dominant
TSC1	somatic mutation|autosomal dominant
MAGEL2	autosomal dominant
SGSH	autosomal recessive
JPH3	autosomal dominant
JPH2	autosomal recessive|autosomal dominant
JPH1	autosomal recessive, autosomal dominant
NDRG1	autosomal recessive
AICDA	autosomal recessive
NCSTN	autosomal dominant
MCOLN1	autosomal dominant|autosomal recessive
PIDD1	autosomal recessive
USH1C	autosomal recessive
ATP6V0A4	autosomal recessive
HNMT	autosomal dominant vs. multifactorial|autosomal recessive
XPR1	autosomal dominant
CORIN	autosomal recessive
NOL3	autosomal dominant
WNK1	autosomal recessive|autosomal dominant
RERE	autosomal dominant
DIABLO	autosomal dominant
HCN4	autosomal dominant
ADCY10	autosomal dominant
TOR1A	autosomal recessive|autosomal dominant
NANS	autosomal recessive
KYNU	autosomal recessive
MESP2	autosomal recessive
CFC1	autosomal dominant
DLL4	autosomal dominant
GAS8	autosomal recessive
PXDN	autosomal recessive
CFAP45	autosomal recessive
ANKH	autosomal dominant
WWOX	autosomal recessive|somatic mutation, autosomal dominant
SPINT2	autosomal recessive
GDF2	autosomal dominant
AASS	autosomal recessive
S1PR2	autosomal recessive
HERC1	autosomal recessive
MASP2	autosomal recessive
TAB2	autosomal dominant
PPM1D	autosomal dominant, somatic mutation|autosomal dominant
SH2B3	autosomal dominant|somatic mutation
PIGK	autosomal recessive
TREM2	autosomal recessive
MICU1	autosomal recessive
FRZB	multifactorial
CNGB3	autosomal recessive
TARDBP	autosomal dominant
TRIM37	autosomal recessive
GIPC1	autosomal dominant
KIF23	autosomal dominant
SHPK	autosomal recessive
IRF7	autosomal recessive
MED27	autosomal recessive
MED23	autosomal recessive
WASF1	autosomal dominant
CPLX1	autosomal recessive
PLK4	autosomal recessive
ITGA3	autosomal recessive
PAK2	autosomal dominant
VSX1	autosomal dominant
CYLD	autosomal dominant
STX11	autosomal recessive
SUPT16H	autosomal dominant
ADAMTS3	autosomal recessive
SPINK5	autosomal recessive
CORO1A	autosomal recessive
NHERF1	autosomal dominant
SPTBN2	autosomal dominant|autosomal recessive
POLG2	autosomal recessive|autosomal dominant
HPS1	autosomal recessive
WBP4	autosomal recessive
RACGAP1	autosomal recessive
PRKAG3	autosomal recessive
SOX5	autosomal dominant
FCN3	autosomal recessive
STK4	autosomal recessive
PDE11A	autosomal dominant
SLC26A5	autosomal recessive
TBCE	autosomal recessive
MUTYH	autosomal recessive
CTDP1	autosomal recessive
PCLO	autosomal recessive
CNOT1	autosomal dominant
TAF2	autosomal recessive
CNOT3	autosomal dominant
CNOT2	autosomal dominant
TNFRSF13B	autosomal recessive, autosomal dominant
BRF1	autosomal recessive
DGAT1	autosomal recessive
MKKS	autosomal recessive
TBX21	autosomal recessive
NBEA	autosomal dominant
NEUROG3	autosomal recessive
SLC12A6	autosomal recessive|autosomal dominant
MYO9A	autosomal recessive
MPZL2	autosomal recessive
TAS2R16	autosomal dominant|probably multifactorial, genetically influenced
LRAT	autosomal recessive
MALT1	autosomal recessive
SRP68	autosomal recessive
SRP54	autosomal dominant
HS6ST1	autosomal dominant
HS2ST1	autosomal recessive
SLCO1B1	digenic recessive
FKBP6	autosomal recessive
TBK1	autosomal dominant
EVC	autosomal dominant|autosomal recessive
KL	autosomal recessive
PUF60	autosomal dominant
FLRT3	autosomal dominant (see miscellaneous below)
HOMER2	autosomal dominant
ABHD5	autosomal recessive
TRPA1	autosomal dominant
ANGPTL3	autosomal recessive
ACAD8	autosomal recessive
PRDX3	autosomal dominant|autosomal recessive
NPHS2	autosomal recessive
SYCP3	autosomal dominant
RELB	autosomal recessive
AKR1D1	autosomal recessive
WDR1	autosomal recessive
WARS2	autosomal recessive
TULP3	autosomal recessive
TSFM	autosomal recessive
TFR2	autosomal recessive
TSPYL1	autosomal recessive
RRM2B	autosomal recessive|autosomal dominant
LTBP4	autosomal recessive
MERTK	autosomal recessive
TOM1	autosomal dominant
ARL3	autosomal recessive|autosomal dominant
AKAP3	autosomal recessive
HOXA2	autosomal dominant, autosomal recessive
CERT1	autosomal dominant
MAP3K14	autosomal recessive
SLC40A1	autosomal dominant
TBCD	autosomal recessive
MAPK8IP1	autosomal dominant
ACTN4	autosomal dominant
EFEMP2	autosomal recessive
VAC14	autosomal recessive
NR0B2	autosomal dominant, autosomal recessive, multifactorial
MMP20	autosomal recessive
HSPB3	autosomal dominant
LGI1	autosomal dominant
TBR1	autosomal dominant
TBX19	autosomal recessive
TBX18	autosomal dominant
WRN	autosomal recessive
BLM	autosomal recessive
SLC30A9	autosomal recessive
MYOF	autosomal dominant
GRIP1	autosomal recessive
CRIPT	autosomal recessive
KIF5C	autosomal dominant
TCIRG1	autosomal recessive
FCGR2B	autosomal dominant
NEK1	autosomal recessive|autosomal dominant|autosomal recessive, digenic recessive
PDGFRL	somatic mutation, autosomal dominant|somatic mutation
AFG3L2	autosomal dominant|autosomal recessive
FBLN5	autosomal dominant|autosomal recessive
FZD4	autosomal dominant
BVES	autosomal recessive
FRRS1L	autosomal recessive
CNTNAP2	autosomal recessive
ALG6	autosomal recessive
ALG5	autosomal dominant
ICOS	autosomal recessive
ZNF423	autosomal dominant, autosomal recessive
DYRK1B	autosomal dominant
HSF2BP	autosomal recessive
TONSL	autosomal recessive
LARS2	autosomal recessive
ADAMTS2	autosomal recessive
IDH3B	autosomal recessive
CELSR1	autosomal dominant
HAAO	autosomal recessive
BLNK	autosomal recessive
TRIP13	autosomal recessive
TRIP12	autosomal dominant
TRIP11	autosomal recessive
TRIP4	autosomal recessive
ZNHIT3	autosomal recessive
CBLB	autosomal recessive
SACS	autosomal recessive
AMACR	autosomal recessive
TCAP	autosomal dominant|autosomal recessive
OTOG	autosomal recessive
NR2E3	autosomal recessive|autosomal dominant, autosomal recessive
GRM1	autosomal dominant|autosomal recessive
SP110	autosomal recessive
SARDH	autosomal recessive
PSMD12	autosomal dominant
GNB5	autosomal recessive
GAB1	autosomal recessive
SLC38A3	autosomal recessive
PLPBP	autosomal recessive
KLK11	autosomal dominant
SCN10A	autosomal dominant
GJB6	autosomal dominant|autosomal recessive|autosomal recessive, digenic dominant (see miscellaneous)
AFF4	autosomal dominant
LETM1	autosomal recessive
GPC6	autosomal recessive
ST3GAL5	autosomal recessive
MLH3	somatic mutation, autosomal dominant
AIPL1	autosomal recessive, autosomal dominant
TRPS1	autosomal dominant
SCN11A	autosomal dominant
ATP2C1	autosomal dominant
GFI1B	autosomal dominant, autosomal recessive (in 1 patient)
CHEK2	somatic mutation|somatic mutation, autosomal dominant
GPNMB	autosomal recessive
DNAI1	autosomal recessive
PROM1	autosomal recessive, autosomal dominant|autosomal dominant|autosomal recessive
STAG1	autosomal dominant
MAB21L2	autosomal dominant, autosomal recessive (1 family)
LAMC3	autosomal recessive
MAN1B1	autosomal recessive
CHIC2	autosomal dominant, somatic mutation
GRAP	autosomal recessive
B4GALT7	autosomal recessive
PPP2R2B	autosomal dominant
SLC17A5	autosomal recessive
TINF2	autosomal dominant
GALK1	autosomal recessive
CST3	autosomal dominant
BLOC1S6	autosomal recessive
HLA-DQB1	autosomal recessive, multifactorial|autosomal dominant|multifactorial
ACTL7A	autosomal recessive
APPL1	autosomal dominant
SYNJ1	autosomal recessive
GRHPR	autosomal recessive
VAX1	autosomal recessive
RAD54B	somatic mutation, autosomal dominant
AGXT	autosomal recessive
PRG4	autosomal recessive
PLXND1	autosomal recessive
SPAST	autosomal dominant
SCO2	autosomal recessive|autosomal dominant
LRP4	autosomal recessive|autosomal dominant, autosomal recessive
FAT2	autosomal dominant
MEGF8	autosomal recessive
ATG5	autosomal recessive
STAT5B	autosomal recessive|autosomal dominant
DLC1	somatic mutation, autosomal dominant
LBX1	autosomal recessive
RNF6	somatic mutation, autosomal dominant
CRLF1	autosomal recessive
ARPC5	autosomal recessive
ARPC4	autosomal dominant
ARPC1B	autosomal recessive
SLC34A2	autosomal recessive
KRIT1	autosomal dominant
PARN	autosomal recessive|autosomal dominant
CRB1	autosomal recessive|autosomal dominant vs. x-linked
SNAP29	autosomal recessive
RAB11B	autosomal dominant
MTHFS	autosomal recessive
SLC27A4	autosomal recessive
SLC22A4	unproved inheritance
SELENBP1	autosomal recessive
RPL18	autosomal dominant
RPL11	autosomal dominant
RPL15	autosomal dominant
CTCF	autosomal dominant
SLC25A11	autosomal dominant
KISS1R	autosomal dominant|autosomal recessive
SLC6A5	autosomal dominant, autosomal recessive
SGCE	autosomal dominant
SLC7A9	autosomal dominant, autosomal recessive
TYROBP	autosomal recessive
ARFGEF1	autosomal dominant
DNAJB2	autosomal recessive
ADAMTS13	autosomal recessive
TBX15	autosomal recessive
SVIL	autosomal recessive
SULT2B1	autosomal recessive
RBBP8	autosomal recessive
RNASEH1	autosomal recessive
PIGB	autosomal recessive
KCNQ1OT1	autosomal dominant
IL18BP	autosomal recessive
ADGRG1	autosomal recessive
SYCP2	autosomal dominant
MYOT	autosomal dominant
GRM7	autosomal recessive
GRM6	autosomal recessive
EDAR	autosomal dominant|autosomal recessive
MAD2L2	autosomal recessive
DLG5	autosomal recessive
PPP1R17	autosomal dominant, autosomal recessive
ZNF142	autosomal recessive
RGS9	autosomal recessive
CACNA1G	autosomal dominant
ITGA8	autosomal recessive
SEPTIN9	autosomal dominant
NEK2	autosomal recessive
MPDU1	autosomal recessive
RAD50	autosomal recessive
EIF2AK3	autosomal recessive
GOSR2	autosomal recessive
AXIN2	somatic mutation, autosomal dominant|autosomal dominant
SLC5A6	autosomal recessive
UNC119	autosomal dominant
AKAP9	autosomal dominant
POLH	autosomal recessive
SCN4A	autosomal recessive|autosomal dominant
RASGRP1	autosomal recessive
SEMA3A	autosomal dominant (see miscellaneous below)
CCIN	autosomal recessive
CLDN16	autosomal recessive
DRG1	autosomal recessive
KCNMB1	autosomal dominant
HELLS	autosomal recessive
EIF2B5	autosomal recessive
GYG1	autosomal recessive
SLC19A2	autosomal recessive
RP1	autosomal dominant, autosomal recessive
GDF11	autosomal dominant
GPHN	autosomal recessive
HABP2	autosomal dominant
SUCLA2	autosomal recessive
EIF3F	autosomal recessive
ITM2B	autosomal dominant
ZPR1	autosomal recessive
EFTUD2	autosomal dominant
TIMELESS	autosomal dominant
BAG5	autosomal recessive
BAG3	autosomal dominant
PLAA	autosomal recessive
RAB27A	autosomal recessive
PEX11B	autosomal recessive
SLC25A15	autosomal recessive
SLC25A13	autosomal recessive
MKRN3	autosomal dominant
PHOX2B	autosomal dominant
DNM1L	autosomal dominant, autosomal recessive|autosomal dominant
NDUFS6	autosomal recessive
NDUFS3	autosomal recessive
NDUFC2	autosomal recessive
NDUFB10	autosomal recessive
NDUFB7	autosomal recessive
NDUFB3	autosomal recessive
NDUFA10	autosomal recessive
NDUFA9	autosomal recessive
NDUFA4	autosomal recessive
NR1H4	autosomal recessive
GNE	autosomal recessive|autosomal dominant
AXIN1	autosomal recessive|somatic mutation
BANF1	autosomal recessive
MED17	autosomal recessive
MED13	autosomal dominant
TGM5	autosomal recessive
CHST3	autosomal recessive
KCNE2	autosomal dominant
LITAF	autosomal dominant
MPDZ	autosomal recessive
RECQL4	autosomal recessive
COX5A	autosomal recessive
KLK4	autosomal recessive
GSTZ1	autosomal recessive
ABCG2	? autosomal dominant form
KIF3B	autosomal dominant
UBE4A	autosomal recessive
APOL1	autosomal dominant
ALOX12B	autosomal recessive
IRF3	autosomal dominant
SGPL1	autosomal recessive
QARS1	autosomal recessive
FGF17	autosomal dominant (see miscellaneous below)
ELP1	somatic mutation, autosomal dominant, autosomal recessive|autosomal recessive
CLDN1	autosomal recessive
GCM2	autosomal dominant|autosomal recessive, autosomal dominant (in 2 families)
SIX3	autosomal dominant
CYP7B1	autosomal recessive
ADAM22	autosomal recessive
MOCS2	autosomal recessive
MOCS1	autosomal recessive
RPL26	autosomal dominant
RPS27	autosomal dominant
RPS26	autosomal dominant
ALOX5AP	multifactorial predisposition
GBF1	autosomal dominant
ZFPM2	autosomal dominant
SLC33A1	autosomal recessive|autosomal dominant
ALDH1A2	autosomal recessive
RPS28	autosomal dominant
RPS23	autosomal dominant
OTOF	autosomal recessive
ATXN8OS	autosomal dominant, multifactorial|autosomal dominant
RPS15A	autosomal dominant
PTCH2	somatic mutation, autosomal dominant, autosomal recessive
SLC25A12	autosomal recessive
STX16	autosomal dominant
RPS7	autosomal dominant
TRPC6	autosomal dominant
BBS5	autosomal recessive
COX11	autosomal recessive
BCS1L	autosomal recessive
COX15	autosomal recessive
GATB	autosomal recessive
SCO1	autosomal recessive
ADAM17	autosomal recessive
RPL21	autosomal dominant
RPL5	autosomal dominant
RPS29	autosomal dominant
RPS10	autosomal dominant
YARS1	autosomal dominant|autosomal recessive
FZR1	autosomal dominant
CDC20	autosomal recessive
SLC24A1	autosomal recessive
RAD54L	autosomal dominant, somatic mutation
TNFRSF10B	autosomal recessive
AIMP1	autosomal recessive
PLA2G6	autosomal recessive
PIK3C2A	autosomal recessive
SOCS1	autosomal dominant
SLC7A7	autosomal recessive
LARGE1	autosomal recessive
MADD	autosomal recessive
TRPM1	autosomal recessive
NME5	autosomal recessive
MBD4	autosomal dominant|autosomal recessive
DPM2	autosomal recessive
SBF1	autosomal recessive
MTMR2	autosomal recessive
EYA4	autosomal dominant
CCNK	autosomal dominant
GABBR1	autosomal dominant
CTSF	autosomal recessive
KCNQ4	autosomal dominant
AP1G1	autosomal dominant|autosomal recessive
AP1S1	autosomal recessive
DPH1	autosomal recessive
TIA1	autosomal dominant|autosomal dominant, autosomal recessive
BCL10	autosomal recessive|somatic mutation
LRP6	autosomal dominant
LRP5	autosomal dominant|autosomal dominant, autosomal recessive|autosomal recessive
CDC14A	autosomal recessive
DPM1	autosomal recessive
TNFRSF11A	autosomal dominant|autosomal recessive
AURKC	autosomal recessive
IGSF3	autosomal recessive
WNT4	autosomal recessive|autosomal dominant
NFS1	autosomal recessive
RPS19	autosomal dominant
ASS1	autosomal recessive
CDC45	autosomal recessive
CDK10	autosomal recessive
DPH2	autosomal recessive
CRADD	autosomal recessive
RIPK1	autosomal dominant|autosomal recessive
DAB1	autosomal dominant
PER3	autosomal dominant
PER2	autosomal dominant
PRKRA	autosomal recessive
PDLIM4	autosomal dominant
SCN9A	autosomal dominant|autosomal recessive
FZD6	autosomal recessive
DHX16	autosomal dominant
AP3B1	autosomal recessive
CCN6	autosomal recessive
SPAG1	autosomal recessive
PDE8B	autosomal dominant
NAE1	autosomal recessive
SYNGAP1	autosomal dominant
MSH5	autosomal recessive
FLNB	autosomal dominant|autosomal recessive
SLC22A5	autosomal recessive
TSHR	autosomal dominant|autosomal recessive
GLE1	autosomal recessive
UGDH	autosomal recessive
CDK6	autosomal recessive
PEX16	autosomal recessive
NDUFA8	autosomal recessive
SERPINB7	autosomal recessive
CD164	autosomal dominant
MBTPS1	autosomal recessive
EPAS1	autosomal dominant
SLC4A4	autosomal recessive
DNAH11	autosomal recessive
DNAH8	autosomal recessive
DNAH5	autosomal recessive
DNAH2	autosomal recessive
DNAH1	autosomal recessive
DYNC1I2	autosomal recessive
DNAH9	autosomal recessive
GJB3	autosomal dominant|autosomal recessive, digenic dominant (see miscellaneous)|autosomal dominant, autosomal recessive (rare)
PTPRQ	autosomal dominant|autosomal recessive
ALG10B	autosomal dominant
CDK13	autosomal dominant
BFSP1	autosomal recessive, autosomal dominant
KCNH1	autosomal dominant
DYNC2H1	autosomal recessive, digenic recessive
SMAD9	autosomal dominant
MCM3AP	autosomal recessive
KERA	autosomal recessive
PNPO	autosomal recessive
KISS1	autosomal recessive
TRDN	autosomal recessive
CHD4	autosomal dominant
RGS5	multifactorial
TP63	autosomal dominant
CAPN15	autosomal recessive
CA12	autosomal recessive
IKBKB	autosomal dominant|autosomal recessive
SMARCA4	autosomal dominant
FOXL1	autosomal dominant
BMPR1B	autosomal recessive|autosomal dominant
AMFR	autosomal recessive
MVD	autosomal dominant
ABCC6	autosomal recessive|autosomal dominant
KCNK3	autosomal dominant
ABCD4	autosomal recessive
KIF22	autosomal dominant
BFSP2	autosomal dominant
KCNJ13	autosomal recessive|autosomal dominant
LCT	autosomal recessive
ABCB11	autosomal recessive
RFXANK	autosomal recessive
CAVIN1	autosomal recessive
PNPLA6	autosomal recessive
COCH	autosomal recessive|autosomal dominant
CFAP410	autosomal recessive
STX5	autosomal recessive
CDK8	autosomal dominant
RTN2	autosomal recessive|autosomal dominant
ALDH6A1	autosomal recessive
PEX3	autosomal recessive
USP8	autosomal recessive vs. dominant men1
PIK3R2	autosomal dominant
PTPN14	autosomal recessive
ATP5F1D	autosomal recessive
PPFIBP1	autosomal recessive
CUL3	autosomal dominant
PMPCB	autosomal recessive
DOCK3	autosomal recessive
DOCK2	autosomal recessive
PPP2R1B	somatic mutation, autosomal dominant
SMARCE1	autosomal dominant
SMAD3	autosomal dominant
TCF20	autosomal dominant
CPN1	autosomal recessive
AGPAT2	autosomal recessive
BAP1	autosomal dominant
SLC31A1	autosomal recessive
DARS1	autosomal recessive
CHEK1	autosomal dominant
ZIC2	autosomal dominant
AURKA	somatic mutation, autosomal dominant
PLOD3	autosomal recessive
KIF1C	autosomal recessive
DCHS1	autosomal dominant|autosomal recessive
ORC4	autosomal recessive
AGPS	autosomal recessive
GPAA1	autosomal recessive
COLQ	autosomal recessive
TLR5	autosomal dominant
TLR3	autosomal dominant, autosomal recessive
TLR2	somatic mutation, autosomal dominant|autosomal dominant
FBP2	autosomal dominant
PLAG1	somatic mutation|autosomal dominant
PICALM	autosomal dominant, somatic mutation
ARID1A	autosomal dominant
IKZF1	autosomal dominant
TRRAP	autosomal dominant
DYSF	autosomal recessive
PAPSS2	autosomal recessive
TNPO2	autosomal dominant
CUBN	autosomal recessive
NOG	autosomal dominant
PDE1C	autosomal dominant
NDUFS2	autosomal recessive
KCNN3	autosomal dominant
AEBP1	autosomal recessive
PHC1	autosomal recessive
AQP7	autosomal recessive
EEF1A2	autosomal dominant
FANCG	autosomal recessive
TAF6	autosomal recessive
NSD2	autosomal dominant
RORC	autosomal recessive
BAAT	autosomal recessive
CITED2	autosomal dominant
SMAD6	autosomal dominant (see qualifier below)|autosomal dominant
STXBP1	autosomal dominant, autosomal recessive (in 1 family)
FARSA	autosomal recessive
CACNG2	autosomal dominant
DNMT3B	digenic, dominant|autosomal recessive
DLG4	autosomal dominant
GDF1	autosomal dominant|autosomal recessive
EPB41L1	autosomal dominant
OCLN	autosomal recessive
IMPG1	autosomal dominant, autosomal recessive (see miscellaneous)|autosomal dominant
HNRNPU	autosomal dominant
IGFBP7	autosomal recessive
PKP2	autosomal dominant
BUB1B	autosomal dominant|somatic mutation, autosomal dominant|autosomal recessive
PEX10	autosomal recessive
DHCR7	autosomal recessive
NUDT2	autosomal recessive
ADGRV1	autosomal dominant|autosomal recessive, digenic dominant (see miscellaneous)
GMNN	autosomal dominant
CD70	autosomal recessive
PIK3CD	digenic recessive|autosomal dominant|autosomal recessive
H4C9	autosomal dominant
H4C5	autosomal dominant
H4C3	autosomal dominant
H4C11	autosomal dominant
KIF5A	autosomal dominant
SPG7	autosomal recessive, autosomal dominant
HCN2	autosomal dominant
HCN1	autosomal dominant
SNAPC4	autosomal recessive
SHOC2	autosomal dominant
RAD51C	autosomal recessive
CBX2	autosomal recessive
DNMT3A	autosomal dominant, somatic mutation|autosomal dominant
DLL3	autosomal recessive
KRT85	autosomal recessive
KRT83	autosomal recessive|autosomal dominant
PI4KB	autosomal dominant
KCNN4	autosomal dominant
PHOX2A	autosomal recessive
DUSP6	autosomal dominant (see miscellaneous below)
GNPAT	autosomal recessive
PRKAG2	autosomal dominant
ATP5MC3	autosomal dominant
PLS1	autosomal dominant
FYB1	autosomal recessive
CLCN7	autosomal dominant|autosomal recessive
CLCN6	autosomal dominant
GRIN2D	autosomal dominant
NPHS1	autosomal recessive
LMOD1	autosomal recessive
ADAM9	autosomal recessive
PSMC1	autosomal recessive
MDM4	autosomal dominant
KATNB1	autosomal recessive
EP300	somatic mutation, autosomal dominant|autosomal dominant
MCM5	autosomal recessive
NDUFS4	autosomal recessive
SDHD	autosomal recessive|autosomal dominant
MAD1L1	autosomal recessive|somatic mutation, autosomal dominant
PCYT2	autosomal recessive
MARK3	autosomal recessive
PDE6D	autosomal recessive
SLC37A4	autosomal dominant|autosomal recessive
PITX3	autosomal dominant|autosomal dominant, autosomal recessive (in 2 patients)
NBN	autosomal recessive
MYO15A	autosomal recessive (17p12-q12)
TUBB4A	autosomal dominant
TUBB3	autosomal dominant
TUBB4B	autosomal dominant
PDE2A	autosomal recessive
NTHL1	autosomal recessive
SPOP	autosomal dominant
TNFRSF11B	autosomal recessive
TNFSF11	autosomal recessive, also a mild dominant form and a lethal recessive form
MCM4	autosomal recessive
DEAF1	autosomal recessive|autosomal dominant
SLC22A18	autosomal dominant, somatic mutation|somatic mutation, autosomal dominant|autosomal recessive
TGIF1	autosomal dominant
CDC6	autosomal recessive
CTBP1	autosomal dominant
FOXE1	autosomal dominant|autosomal recessive
MGAT2	autosomal recessive
MAP3K7	autosomal dominant
CARTPT	autosomal dominant, autosomal recessive, multifactorial
CDSN	autosomal dominant|autosomal recessive
KIF2A	autosomal dominant
PAK1	autosomal dominant
FUT8	autosomal recessive
GOLGA2	autosomal recessive
LFNG	autosomal recessive
LMX1B	autosomal dominant
TECTA	autosomal dominant|autosomal recessive
ANXA11	autosomal dominant
JAG2	autosomal recessive
SNCB	autosomal dominant
MTRR	? autosomal recessive|autosomal recessive
NUP88	autosomal recessive
PRKN	somatic mutation, autosomal dominant|somatic mutation|autosomal recessive
CELF2	autosomal dominant
CAPN5	autosomal dominant (11q13)
RAB3GAP1	autosomal recessive
PARK7	autosomal recessive
TUBA1A	autosomal dominant
USP7	autosomal dominant
TFG	autosomal recessive|autosomal dominant
NRIP1	autosomal dominant
POP1	autosomal recessive
POU3F3	autosomal dominant
SPRY2	autosomal dominant
POU4F3	autosomal dominant
SORT1	autosomal dominant
FADD	autosomal recessive
BUB1	somatic mutation, autosomal dominant|autosomal recessive
SERPINI1	autosomal dominant
HSF4	autosomal dominant
OPTN	autosomal dominant, autosomal recessive|autosomal dominant
ROBO2	autosomal dominant
ROBO1	autosomal recessive|autosomal dominant
TBX6	autosomal recessive, autosomal dominant
CFTR	autosomal dominant|autosomal recessive
SDHC	autosomal dominant, isolated cases|autosomal dominant
RPS24	autosomal dominant
BRPF1	autosomal dominant
MLLT10	autosomal dominant, somatic mutation
FOXC2	autosomal dominant
ATP8B1	autosomal recessive|autosomal dominant
TUFM	autosomal recessive
PLD1	autosomal recessive
DNM2	autosomal dominant|autosomal recessive
DNM1	autosomal dominant|autosomal recessive
IFNAR2	autosomal recessive
MRPL12	autosomal recessive
GRID2	autosomal recessive
NPTX1	autosomal dominant
CTSC	autosomal recessive
GATM	autosomal recessive|autosomal dominant
HCRT	autosomal dominant
WIPF1	autosomal recessive
LAT	autosomal recessive
CNTNAP1	autosomal recessive
TRPC3	autosomal dominant
ROR2	autosomal dominant|autosomal recessive
ROR1	autosomal recessive
EMP2	autosomal recessive
NCAPH	autosomal recessive
TERC	autosomal dominant
AGRP	autosomal dominant, autosomal recessive, multifactorial
HR	autosomal recessive
RAB7A	autosomal dominant
AP4M1	autosomal recessive
CIB1	autosomal recessive
ECHS1	autosomal recessive
FOXJ1	autosomal dominant
TRIM32	autosomal recessive
SC5D	autosomal recessive
TULP1	autosomal recessive
PABPN1	autosomal dominant
GUCA1B	autosomal dominant
GALNT2	autosomal recessive
TCF4	autosomal dominant
SCARB2	autosomal recessive
TNFRSF9	autosomal recessive
DNASE1L3	autosomal recessive
CD151	autosomal recessive
AP2S1	autosomal dominant
MIPEP	autosomal recessive
EXOSC2	autosomal recessive
KCNQ2	autosomal dominant
KCNQ3	autosomal dominant
SOX10	autosomal dominant
TCF7L2	autosomal dominant
CRX	autosomal dominant (19q13.1-q13.2)
ZMYM2	autosomal dominant
SALL2	autosomal recessive
SALL1	autosomal dominant
STK11	autosomal dominant|autosomal dominant, somatic mutation, multifactorial|somatic mutation
SIAH1	autosomal dominant
KCNJ10	autosomal recessive
RAB18	autosomal recessive
DDOST	autosomal recessive
ECM1	autosomal recessive
HSPB1	autosomal dominant
HTRA1	autosomal recessive|autosomal dominant
ADAM10	autosomal dominant
NKX3-2	autosomal recessive
PSMB4	autosomal recessive
MYD88	autosomal recessive|somatic mutation
VRK1	autosomal recessive
ESRRB	autosomal recessive
AP3B2	autosomal recessive
KRT81	autosomal dominant
PITX1	autosomal dominant
LHX4	autosomal dominant
BRDT	autosomal recessive
PLCD1	autosomal dominant, autosomal recessive
NDUFS8	autosomal recessive
NDUFB8	autosomal recessive
NDUFA6	autosomal recessive
NDUFA2	autosomal recessive
PEX1	autosomal recessive
DNALI1	autosomal recessive
MAPKAPK3	autosomal dominant
COX10	autosomal recessive
CAMK2G	autosomal dominant
SRP72	autosomal dominant
DIAPH1	autosomal dominant|autosomal recessive
CHD3	autosomal dominant
CHD2	autosomal dominant
CHD1	autosomal dominant
FGF10	autosomal dominant
KMT2D	autosomal dominant
MATN3	sex-influenced autosomal dominant|autosomal dominant|autosomal recessive
MSH4	autosomal recessive
SH3BP2	autosomal dominant
TRAPPC10	autosomal recessive
LTBP2	autosomal recessive
LTBP3	autosomal recessive|autosomal dominant
SATB1	autosomal dominant
COX6A1	autosomal recessive
IMPA1	autosomal recessive
TALDO1	autosomal recessive
TBX1	autosomal dominant
KLF6	somatic mutation, autosomal dominant
RAC3	autosomal dominant
RAC2	autosomal recessive|autosomal dominant
RAC1	autosomal dominant
UCP3	autosomal dominant, autosomal recessive, multifactorial
RHOH	autosomal recessive
EML1	autosomal recessive
PHYH	autosomal recessive
CLCNKA	digenic recessive
CLCNKB	autosomal recessive|digenic recessive
PPP1R12A	autosomal dominant
PSMB1	autosomal recessive
COX6A2	autosomal recessive
POLR1B	autosomal dominant
TNR	autosomal recessive
NOVA2	autosomal dominant
TP73	autosomal recessive
SIGMAR1	autosomal recessive
PKP1	autosomal recessive
RORB	autosomal dominant
WNT2B	autosomal recessive
TAPBP	autosomal recessive
CACNB4	autosomal dominant
CRY1	autosomal dominant
BNC1	autosomal dominant
KRT86	autosomal dominant
ARHGDIA	autosomal recessive
COPA	autosomal dominant
ANGPT2	autosomal dominant
JAG1	autosomal dominant
GDF9	autosomal recessive
MANF	autosomal recessive
GET3	autosomal recessive
SUMO1	isolated cases
DLX4	autosomal dominant
WNT10B	autosomal recessive|autosomal dominant
ORC1	autosomal recessive
GHSR	autosomal dominant, autosomal recessive
ZNF148	autosomal dominant
TRAF3	autosomal dominant
TRIO	autosomal dominant
KPNA3	autosomal dominant
CST6	autosomal recessive
RAX	autosomal recessive
B4GALNT1	autosomal recessive
PLOD2	autosomal recessive
RFX5	autosomal recessive
RFXAP	autosomal recessive
HSD17B4	autosomal recessive
ARHGEF1	autosomal recessive
WNK4	autosomal dominant
SLC5A5	autosomal recessive
LIG4	somatic mutation|autosomal recessive
NR4A2	autosomal dominant
NDUFS7	autosomal recessive
BPTF	autosomal dominant
FXYD2	autosomal dominant
DNA2	autosomal dominant|autosomal recessive
MMP19	autosomal dominant
MCM6	autosomal dominant
HESX1	autosomal dominant, autosomal recessive
TAF4	autosomal dominant
PEX14	autosomal recessive
PEX13	autosomal recessive
MSTN	autosomal recessive
PMM2	autosomal recessive
POLRMT	autosomal recessive, autosomal dominant
CYP1B1	autosomal recessive
VDR	autosomal recessive
SH3GL1	autosomal dominant, somatic mutation
CASP8	autosomal recessive|autosomal dominant, somatic mutation|somatic mutation, autosomal dominant|somatic mutation
CASP10	autosomal dominant
PEX12	autosomal recessive
PEX7	autosomal recessive
GALNT3	autosomal recessive
ENTPD1	autosomal recessive
GLMN	autosomal dominant
HYOU1	autosomal recessive
OSMR	autosomal dominant
MEIS2	autosomal dominant
SMARCD2	autosomal recessive
SMARCD1	autosomal dominant
SMARCC2	autosomal dominant
SMARCC1	autosomal dominant
ATIC	autosomal recessive
PIGC	autosomal recessive
PTEN	autosomal dominant|somatic mutation, autosomal dominant
NEUROG1	autosomal recessive
NEUROD2	autosomal dominant
NEUROD1	autosomal dominant
FZD5	autosomal dominant
TBX4	autosomal recessive|autosomal dominant
STXBP2	autosomal recessive
PTGIS	multifactorial
SERPINB8	autosomal recessive
TGFBI	autosomal dominant
ABCA4	autosomal dominant|autosomal recessive
PLA2G7	autosomal recessive
TAF4B	autosomal recessive
HPGD	autosomal recessive
KRT12	autosomal dominant
COQ7	autosomal recessive
DPF2	autosomal dominant
ANGPT1	autosomal dominant
SNRNP200	autosomal dominant
ESR2	autosomal dominant
GATA6	autosomal dominant
EYA1	autosomal dominant
MYOC	autosomal dominant
PPP2R5D	autosomal dominant
ACOX2	autosomal recessive
PRKACA	autosomal dominant
NSF	autosomal dominant
POU4F1	autosomal dominant
SMN2	autosomal recessive
UBE3A	autosomal dominant (loss of maternal allele)
TWIST1	autosomal dominant|autosomal dominant, ? same as saethre-chotzen syndrome
TBX3	autosomal dominant
TBX5	autosomal dominant
SOX18	autosomal recessive|autosomal dominant
RDH5	autosomal dominant, autosomal recessive
ABCA3	autosomal recessive
NTN1	autosomal dominant
HADH	autosomal recessive
SMARCB1	autosomal dominant
IL12RB1	autosomal recessive
LCP2	autosomal recessive
TFAP2B	autosomal dominant
JARID2	autosomal dominant
BARD1	autosomal dominant, somatic mutation
RAPSN	autosomal recessive
PRKG2	autosomal recessive
NRCAM	autosomal recessive
FOSL2	autosomal dominant
EZH2	autosomal dominant
WNT7A	autosomal recessive
ADD3	autosomal recessive
LMAN1	autosomal recessive
ING1	autosomal recessive
IRF8	autosomal dominant|autosomal recessive
PRSS2	autosomal dominant
ATXN1	autosomal dominant
EFEMP1	autosomal recessive|autosomal dominant
PAFAH1B1	autosomal dominant
PITX2	autosomal dominant
PROP1	autosomal recessive
SQSTM1	autosomal dominant|autosomal recessive
VEGFC	autosomal dominant
ALX1	autosomal recessive
CHI3L1	autosomal dominant
ATXN2	autosomal dominant|autosomal dominant, multifactorial
FGF14	autosomal dominant
FGF12	autosomal dominant
STAT6	autosomal dominant
VPS35	autosomal dominant
SMO	somatic mosaicism|autosomal recessive
PEX6	autosomal recessive|autosomal recessive, autosomal dominant
GFRA1	autosomal recessive
IGFALS	autosomal recessive
NCF4	autosomal recessive
PPARG	autosomal dominant|autosomal dominant, autosomal recessive, multifactorial
STX1B	autosomal dominant
MYO1E	autosomal recessive
DGUOK	autosomal recessive
AFF3	autosomal dominant
ATOH1	autosomal dominant
SLCO2A1	autosomal dominant|autosomal recessive
NDUFB9	autosomal recessive
CFL2	autosomal recessive
DGKE	autosomal recessive
ABCC9	autosomal dominant|autosomal recessive
RNU4ATAC	autosomal recessive
OXCT1	autosomal recessive
KARS1	autosomal recessive
SLC39A7	autosomal recessive
SGCD	autosomal recessive
KAT5	autosomal dominant
KAT6A	autosomal dominant
CTRC	autosomal dominant
GPR68	autosomal recessive
TBXT	autosomal dominant|autosomal recessive
TUSC3	autosomal recessive
DVL3	autosomal dominant
SMAD2	autosomal dominant
DVL1	autosomal dominant
MOGS	autosomal recessive
GUCY2C	autosomal dominant|autosomal recessive
SCN2B	autosomal dominant
CLDN11	autosomal dominant
HINT1	autosomal recessive
PKD1	autosomal dominant
PTCH1	autosomal dominant
PPIL1	autosomal recessive
ACVR1B	autosomal dominant, somatic mutation, multifactorial
BMPR1A	autosomal dominant
MUSK	autosomal recessive
SLC10A2	autosomal recessive
ACVRL1	autosomal dominant
PLEC	autosomal recessive|autosomal dominant
MAB21L1	autosomal recessive
C1QBP	autosomal recessive
CCR2	autosomal recessive
DUT	autosomal recessive
NODAL	autosomal dominant
MAP2K2	autosomal dominant
AMBN	autosomal recessive
KIF1A	autosomal dominant|autosomal recessive
CAV3	autosomal dominant, digenic dominant (see miscellaneous)|autosomal dominant
BIN1	autosomal recessive
SOS2	autosomal dominant
TOP3A	autosomal recessive
GAMT	autosomal recessive
DTNA	autosomal dominant
PIK3CG	autosomal recessive
MTOR	somatic mutation|autosomal dominant
ADARB1	autosomal recessive
ATR	autosomal dominant|autosomal recessive
SIX1	autosomal dominant
CASR	autosomal dominant|autosomal recessive, autosomal dominant (de novo in some patients)
TUB	autosomal recessive
PLA2G5	autosomal recessive
PDE6H	autosomal dominant, autosomal recessive
DNAJC3	autosomal recessive
RANBP2	autosomal dominant
CAPRIN1	autosomal dominant
ARL2	autosomal dominant
CCL11	autosomal dominant vs. multifactorial
DDX11	autosomal recessive
IDH3A	autosomal recessive
GDF6	autosomal dominant|autosomal recessive
GDF5	autosomal recessive|autosomal recessive, autosomal dominant (milder phenotype)|autosomal dominant
CSTB	autosomal recessive
DCTN1	autosomal dominant, autosomal recessive|autosomal dominant
STT3A	autosomal dominant|autosomal recessive
CYP2C9	autosomal dominant
H3-3A	autosomal dominant
CLPP	autosomal recessive
CAMLG	autosomal recessive
ABCC2	autosomal recessive
CTSK	autosomal recessive
MFAP5	autosomal dominant
EIF4A2	autosomal dominant, autosomal recessive (1 family)
PMP22	? autosomal dominant form|autosomal dominant|autosomal dominant, autosomal recessive
FOXE3	autosomal dominant|autosomal recessive
FOXI1	autosomal recessive
FOXC1	autosomal dominant
FOXF1	autosomal dominant
AARS1	autosomal dominant|autosomal recessive
H3-3B	autosomal dominant
PLXNA1	autosomal recessive
CAV1	autosomal recessive|autosomal dominant
CTNND1	autosomal dominant
HNRNPH1	autosomal dominant
LAMA5	autosomal recessive
AP2M1	autosomal dominant
VCP	autosomal dominant
NFKBIL1	unproved inheritance
SLC6A9	autosomal recessive
SNTA1	autosomal dominant
NPC2	autosomal recessive
CACNA1E	autosomal dominant
CACNA1B	autosomal recessive
CACNA1A	autosomal dominant
LEPR	autosomal recessive
GSS	autosomal recessive
GNAQ	autosomal dominant|somatic mosaicism
EPHB2	autosomal recessive
SMAD4	autosomal dominant|autosomal dominant, somatic mutation, multifactorial
TNXB	autosomal recessive|autosomal dominant
NR3C2	autosomal dominant
MAP3K1	autosomal dominant
DMP1	autosomal recessive
MYO6	autosomal dominant|autosomal recessive
SLC12A3	autosomal recessive
SET	autosomal dominant
COPB1	autosomal recessive
MYBPC3	autosomal dominant|autosomal dominant (incomplete penetrance), autosomal recessive
AMH	autosomal recessive with male sex limitation
AMHR2	autosomal recessive with male sex limitation
GHR	autosomal dominant, autosomal recessive|autosomal dominant|autosomal recessive
DHPS	autosomal recessive
SERPINH1	multifactorial|autosomal recessive
LIG3	autosomal recessive
IL11RA	autosomal recessive
KCNJ11	autosomal dominant|autosomal recessive, autosomal dominant
HMMR	autosomal dominant, somatic mutation
CRYBB1	autosomal dominant, autosomal recessive
NPRL3	autosomal dominant
PTPRJ	somatic mutation, autosomal dominant|autosomal recessive
GFER	autosomal recessive
PPOX	autosomal dominant|autosomal recessive
MYLK	autosomal dominant|autosomal recessive
FGF9	autosomal dominant
PPP1R3A	autosomal dominant
LSS	autosomal recessive
SGCB	autosomal recessive
PRKDC	autosomal recessive
SOX11	autosomal dominant
GJA8	autosomal dominant
HADHA	autosomal recessive
MSH3	somatic mutation, autosomal dominant|autosomal recessive
KCNJ6	autosomal dominant
STX3	autosomal recessive
GFI1	autosomal dominant
CSNK1D	autosomal dominant
AIMP2	autosomal recessive
SDHA	autosomal recessive|autosomal dominant
CDKN1C	autosomal dominant
DYRK1A	autosomal dominant
NDST1	autosomal recessive
P2RX2	autosomal dominant
SLC12A2	autosomal dominant|autosomal recessive
SLC12A1	autosomal recessive
FOXN1	autosomal recessive|autosomal dominant
GDNF	autosomal dominant
CRYBA2	autosomal dominant
INPPL1	autosomal recessive
ATP5PO	autosomal recessive
PDE6C	autosomal recessive
RORA	autosomal dominant
CSRP3	autosomal dominant
ARCN1	autosomal dominant
FXR1	autosomal recessive
MRE11	autosomal recessive
SRSF1	autosomal dominant
DDB2	autosomal recessive
PLCB4	autosomal dominant|autosomal recessive
LAMA3	autosomal recessive
MTNR1B	autosomal dominant
BMPR2	autosomal dominant
IRS2	autosomal dominant
HARS2	autosomal recessive
CDKN1B	autosomal dominant
TAF13	autosomal recessive
MUC5B	autosomal dominant
SCNN1G	autosomal dominant|autosomal recessive
SCNN1B	autosomal dominant|autosomal recessive
PSEN2	autosomal dominant
PTPA	autosomal recessive
SYN2	autosomal dominant
MMP14	autosomal recessive
CEBPE	autosomal recessive|autosomal dominant, autosomal recessive
TBX2	autosomal dominant
KCNJ5	autosomal dominant
PDX1	autosomal dominant|autosomal recessive
NFIB	autosomal dominant
NFIA	autosomal dominant
IHH	autosomal recessive|autosomal dominant
SHH	autosomal dominant
CNGB1	autosomal recessive
PPT1	autosomal recessive
PTPN22	autosomal recessive susceptibility, heterogeneous|unproved inheritance|autosomal dominant
HSD11B1	autosomal dominant
HNRNPK	autosomal dominant
IARS1	autosomal recessive
SCN8A	autosomal dominant
HMGA1	autosomal dominant
LPP	autosomal dominant, somatic mutation
HMGA2	autosomal dominant
IL6ST	autosomal dominant|autosomal recessive
TNNT3	autosomal dominant
TIAM1	autosomal recessive
SLC16A1	autosomal dominant|autosomal dominant, autosomal recessive
KCNJ2	autosomal dominant
MSH6	somatic mutation, autosomal dominant|autosomal dominant|autosomal recessive
XRCC3	autosomal dominant, somatic mutation
UBTF	autosomal dominant
FZD2	autosomal dominant
CHUK	autosomal recessive
MEF2C	autosomal dominant
MEF2A	autosomal dominant
CPT2	autosomal dominant, autosomal recessive|autosomal recessive|autosomal recessive, autosomal dominant
NECTIN1	autosomal recessive
CASP2	autosomal recessive
NKX2-1	autosomal dominant
OPCML	somatic mutation
ETV6	autosomal dominant, somatic mutation|autosomal dominant
STAR	autosomal recessive
P4HA2	autosomal dominant
KLF1	autosomal dominant
PPP1CB	autosomal dominant
NKX2-5	autosomal dominant
ASPH	autosomal recessive
CLCN3	autosomal dominant|autosomal recessive
PTPRO	autosomal recessive
LHX3	autosomal recessive
GATA4	autosomal dominant
LZTR1	autosomal dominant|autosomal recessive
REST	autosomal dominant
CLCN2	autosomal dominant|autosomal recessive
NLGN1	autosomal dominant
NRXN1	autosomal recessive
STAT4	autosomal dominant
STAT2	autosomal recessive
STAT1	autosomal dominant|autosomal recessive
HSPA9	autosomal dominant (another allele in trans may be required)|autosomal recessive
ERBB4	autosomal dominant
RECQL	autosomal recessive
ITGA7	autosomal recessive
VANGL2	autosomal dominant
NDUFV2	autosomal recessive
AUH	autosomal recessive
CPT1A	autosomal recessive
DLX3	autosomal dominant
SLC11A2	autosomal recessive
PLA2G4A	autosomal recessive
MASP1	autosomal recessive
P2RY12	autosomal recessive
RELN	autosomal dominant|autosomal recessive
ABCC8	autosomal dominant|autosomal dominant, autosomal recessive
IGHMBP2	autosomal recessive
EIF4G1	autosomal dominant
NFE2L2	autosomal dominant
NFATC2	autosomal recessive
FGF8	autosomal dominant
TCF12	autosomal dominant|autosomal dominant, autosomal recessive (1 patient)
SKIC2	autosomal recessive
PURA	autosomal dominant
ZIC1	autosomal dominant
ANK3	autosomal recessive
ALDH1A3	autosomal recessive
NTRK2	autosomal dominant
AKR1C4	autosomal recessive
AKR1C2	autosomal recessive
AQP5	autosomal dominant (12q11-q13)
SSBP1	autosomal dominant
TFAM	autosomal recessive
GCNT2	autosomal dominant|autosomal recessive
SLC19A1	autosomal recessive
ECE1	autosomal dominant|multifactorial
NT5C2	autosomal recessive
TTPA	autosomal recessive
PEX5	autosomal recessive, several forms|autosomal recessive
KCNB1	autosomal dominant
XRCC2	autosomal recessive
BBS4	autosomal recessive
SLC25A3	autosomal recessive
GUCA1A	autosomal dominant
FLII	autosomal recessive
KCNJ1	autosomal recessive
SMN1	autosomal recessive
PCGF2	autosomal dominant
SLC18A3	autosomal recessive
DDX6	autosomal dominant
SNAP25	autosomal dominant
TPM4	autosomal dominant
TNFRSF4	autosomal recessive
COMP	autosomal dominant
AQP4	autosomal recessive
ACADSB	autosomal recessive
SLC1A2	autosomal dominant
LMX1A	autosomal dominant
ADCY6	autosomal recessive
ADCY5	autosomal dominant|autosomal recessive
ADCY3	autosomal recessive
GARS1	autosomal dominant
PI4KA	autosomal recessive
HNF4A	autosomal dominant|autosomal dominant (20q12-q13.1)
PEX19	autosomal recessive
NOTCH3	autosomal dominant
NOTCH2	autosomal dominant
DSC3	autosomal recessive
PMS2	autosomal recessive
AHR	autosomal recessive
PDCD1	multifactorial
TGM3	autosomal recessive
CENPF	autosomal recessive
SCN1B	autosomal dominant|autosomal recessive
HMGCS2	autosomal recessive
GABRB2	autosomal dominant
PLCB3	autosomal recessive
SLC1A4	autosomal recessive
SCNN1A	autosomal dominant|autosomal recessive
CCNF	autosomal dominant
GCH1	autosomal dominant, autosomal recessive (rare)|autosomal recessive
TIE1	autosomal dominant
TEK	autosomal dominant|autosomal dominant (9p)
PLCG2	autosomal dominant
RUNX2	autosomal dominant
EPS8	autosomal recessive
KRT2	autosomal dominant, ? same as erythroderma ichthyosiformis congenita of brocq (113800)
EIF5A	autosomal dominant
BRCA2	autosomal dominant, somatic mutation|autosomal dominant|autosomal recessive|somatic mutation, autosomal dominant, autosomal recessive|somatic mutation, autosomal dominant
CRAT	autosomal recessive
GUCY2D	autosomal dominant|autosomal dominant, autosomal recessive (in 1 family)|autosomal recessive
JAK3	autosomal recessive
MST1R	autosomal dominant
SCN5A	? autosomal recessive form vs. multifactorial|autosomal dominant|autosomal recessive
CDKN2A	autosomal dominant
AP1B1	autosomal recessive
PIGH	autosomal recessive
PIGF	autosomal recessive
KCNMA1	autosomal dominant|autosomal recessive
MEOX1	autosomal recessive
ITPR2	autosomal recessive
CREBBP	autosomal dominant
LAMA4	autosomal dominant
PDE4D	autosomal dominant
HNRNPA2B1	autosomal dominant
SGCA	autosomal recessive
DYNC1H1	autosomal dominant
SLC1A3	autosomal dominant
MMP13	autosomal dominant|autosomal recessive
SYT2	autosomal dominant|autosomal recessive
RRAS2	autosomal dominant
TUFT1	autosomal recessive
SYK	autosomal dominant
PTPN12	somatic mutation, autosomal dominant
TBP	autosomal dominant, multifactorial|autosomal dominant
LRP2	autosomal recessive
ITGB2	autosomal recessive
CNGA3	autosomal recessive
ABCA2	autosomal recessive
ABCA1	autosomal dominant|autosomal recessive
DDB1	autosomal dominant
THPO	autosomal recessive|autosomal dominant
BAX	somatic mutation, autosomal dominant
OTX2	autosomal dominant
CHIT1	autosomal recessive
DLX5	autosomal recessive|autosomal dominant
LBR	autosomal dominant|autosomal recessive
CDH11	autosomal recessive|autosomal dominant
MXI1	somatic mutation, autosomal dominant
CYB561	autosomal recessive
CNTN1	autosomal recessive
SMARCA2	autosomal dominant
YY1	autosomal dominant
EPHB4	autosomal dominant
CIITA	unproved inheritance|autosomal recessive
CACNB2	autosomal dominant
SRY	x-linked dominant|y-linked
TBL1Y	y-linked
SHOX	pseudoautosomal recessive|pseudoautosomal dominant
USP9Y	y-linked (yq11.23)
ZNF711	x-linked
ZFX	x-linked
XK	x-linked
KDM5C	x-linked recessive
SLC35A2	x-linked dominant, somatic mosaicism (in males)
UBA1	x-linked recessive|somatic mosaicism
TFE3	x-linked
SERPINA7	x-linked
AR	x-linked|x-linked recessive
TAF1	x-linked recessive
SYP	x-linked recessive
SYN1	x-linked
SOX3	x-linked
SSX1	x-linked
RPGR	x-linked recessive|x-linked
UBE2A	x-linked recessive
RPL10	x-linked recessive
POLA1	x-linked recessive
PHKA1	x-linked recessive
PRPS1	x-linked recessive|x-linked
PGK1	x-linked recessive
PIGA	x-linked recessive|somatic mutation
MAOA	x-linked recessive
MSN	x-linked recessive
FMR1	x-linked dominant|x-linked
LAMP2	x-linked dominant
L1CAM	x-linked recessive
IL2RG	x-linked recessive
HPRT1	x-linked recessive
GLRA2	x-linked
GRIA3	x-linked recessive
G6PD	x-linked
GABRA3	x-linked
GATA1	x-linked recessive|possible disomic homozygosity at 21q11.2
GJB1	x-linked dominant
COL4A6	x-linked recessive
COL4A5	x-linked dominant
CLCN4	x-linked dominant
BGN	x-linked|x-linked recessive
ARR3	x-linked (female limited)
ALAS2	x-linked recessive|x-linked
SPIN4	x-linked
CT55	x-linked recessive
CFAP47	x-linked recessive
TBC1D8B	x-linked
STEEP1	x-linked
KLHL15	x-linked recessive
USP27X	x-linked recessive
GPRASP2	x-linked recessive
LAS1L	x-linked recessive
RNF113A	x-linked
TSR2	x-linked recessive
DNAAF6	x-linked recessive
VMA21	x-linked recessive
CSTF2	x-linked recessive
PDK3	x-linked dominant
IRS4	x-linked recessive
ZC4H2	x-linked recessive|x-linked dominant
COX7B	x-linked dominant
CCDC22	x-linked recessive
F8	x-linked recessive
RS1	x-linked recessive
FRMPD4	x-linked
ANOS1	x-linked recessive
PTCHD1	x-linked recessive
FGF16	x-linked recessive
STAG2	x-linked dominant, x-linked recessive|x-linked
IDS	x-linked recessive
OPN1LW	x-linked recessive|x-linked
OPN1MW	x-linked recessive|x-linked
GPR143	x-linked recessive|x-linked
AFF2	x-linked recessive
PHKA2	x-linked recessive
TMLHE	x-linked recessive
ALG13	x-linked
ELF4	x-linked recessive
RAB39B	x-linked recessive
CYLC1	x-linked
NKAP	x-linked recessive
RP2	x-linked
STS	x-linked recessive
F9	x-linked recessive|x-linked
CNKSR2	x-linked
MAGT1	x-linked recessive
OTUD5	x-linked recessive
CCNQ	x-linked dominant
HUWE1	x-linked
BCORL1	x-linked recessive
DOCK11	x-linked recessive
NDP	x-linked recessive, x-linked dominant (1 family)|x-linked recessive
PORCN	x-linked dominant
AMER1	x-linked dominant
ZDHHC9	x-linked
GLA	x-linked
AP1S2	x-linked recessive
FRMD7	x-linked
C1GALT1C1	x-linked recessive
HNRNPH2	x-linked dominant
MSL3	x-linked dominant
POF1B	x-linked recessive
MCTS1	x-linked recessive
ADGRG2	x-linked
SLITRK2	x-linked
PHF8	x-linked recessive
ATP6AP2	x-linked recessive
BRWD3	x-linked recessive
MID1	x-linked recessive
PHEX	x-linked dominant
FGD1	x-linked recessive
HS6ST2	x-linked recessive
AVPR2	x-linked recessive
OCRL	x-linked recessive
WDR45	x-linked dominant
NEXMIF	x-linked dominant
IQSEC2	x-linked dominant
KIF4A	x-linked recessive
CLDN2	x-linked recessive
ATP11C	x-linked recessive
FANCB	x-linked recessive
PDHA1	x-linked dominant
FTSJ1	x-linked recessive
SH2D1A	x-linked recessive
BCOR	x-linked dominant
CYBB	x-linked recessive
GK	x-linked recessive
NR0B1	x-linked|x-linked recessive
MAGED2	x-linked recessive
PQBP1	x-linked recessive
OTC	x-linked
PCDH19	x-linked
NHS	x-linked, heterozygote expression|x-linked dominant
FAM50A	x-linked recessive
EDA	x-linked recessive|x-linked dominant
SASH3	x-linked recessive
ARHGEF9	x-linked
NLGN4X	x-linked
MTM1	x-linked recessive
PHF6	x-linked recessive
NDUFB11	x-linked|x-linked dominant
PLP1	x-linked recessive
BCAP31	x-linked recessive
THOC2	x-linked recessive
TAFAZZIN	x-linked recessive
GPR101	x-linked
WAS	x-linked recessive
AMELX	x-linked dominant
CHM	x-linked
CD40LG	x-linked recessive
EMD	x-linked recessive
CFP	x-linked recessive
ARX	x-linked recessive|x-linked
RLIM	x-linked
DMD	x-linked recessive|x-linked
SH3KBP1	x-linked recessive
ABCD1	x-linked recessive
GCNA	x-linked
SLC9A7	x-linked recessive
TLR8	x-linked, somatic mosaicism
TLR7	x-linked recessive|x-linked dominant
WNK3	x-linked recessive
TIMM8A	x-linked recessive
CHRDL1	x-linked recessive
NLGN3	x-linked
TEX11	x-linked recessive
USP26	x-linked
TBX22	x-linked
CUL4B	x-linked recessive
BTK	x-linked recessive
UPF3B	x-linked recessive
MBTPS2	x-linked recessive
FOXP3	x-linked recessive
NYX	x-linked recessive
NSDHL	x-linked dominant|x-linked recessive
HDAC6	x-linked dominant
HDAC8	x-linked dominant
ZIC3	x-linked recessive
UBQLN2	x-linked dominant
HSD17B10	x-linked dominant
OGT	x-linked recessive
IKBKG	x-linked|x-linked recessive|x-linked dominant
BMP15	x-linked
TCEAL1	x-linked dominant
SLC9A6	x-linked
SMPX	x-linked dominant|x-linked recessive
IL1RAPL1	x-linked recessive
EBP	x-linked dominant|x-linked recessive
MID2	x-linked recessive
CDKL5	x-linked dominant
TRAPPC2	x-linked recessive
RBMX	x-linked recessive
ATP6AP1	x-linked recessive
TBL1X	x-linked
AMMECR1	x-linked recessive
HMGB3	x-linked
DLG3	x-linked recessive
MED12	x-linked dominant|x-linked recessive
ARSL	x-linked recessive
CASK	x-linked recessive|x-linked
OFD1	x-linked recessive|x-linked dominant
AIFM1	x-linked recessive
GPC4	x-linked recessive
FHL1	x-linked recessive|x-linked dominant|x-linked
EIF2S3	x-linked recessive
DDX3X	x-linked dominant, x-linked recessive
ACSL4	x-linked dominant
PAK3	x-linked recessive
IGBP1	x-linked recessive
IGSF1	x-linked recessive
ABCB7	x-linked
PLS3	x-linked dominant|x-linked vs. multifactorial with high male:female sex ratio
KDM6A	x-linked dominant
OPHN1	x-linked recessive
DKC1	x-linked dominant|x-linked recessive
DCX	x-linked
MAMLD1	x-linked recessive
PRICKLE3	x-linked dominant
CACNA1F	x-linked|x-linked recessive|x-linked form, heterogeneous
DIAPH2	x-linked dominant
SMS	x-linked recessive
GDI1	x-linked dominant
TSPAN7	x-linked recessive
SLC16A2	x-linked
SSR4	x-linked recessive
NONO	x-linked
RBM10	x-linked recessive
XIAP	x-linked recessive
NDUFA1	x-linked recessive
RPS6KA3	x-linked dominant
USP9X	x-linked recessive|x-linked dominant
FGF13	x-linked dominant, x-linked recessive|x-linked recessive
ZMYM3	x-linked recessive
LAGE3	x-linked recessive
HCCS	x-linked dominant
SMC1A	x-linked dominant
POU3F4	x-linked recessive
GPC3	x-linked recessive|autosomal dominant, somatic mutation
SLC6A8	x-linked recessive
EFNB1	x-linked dominant
ATRX	x-linked dominant|x-linked recessive
HCFC1	x-linked recessive
FLNA	x-linked|x-linked recessive|x-linked dominant
ATP2B3	x-linked recessive
NAA10	x-linked|x-linked recessive, x-linked dominant
ATP7A	x-linked recessive
CLCN5	x-linked recessive
MECP2	x-linked|x-linked recessive|x-linked dominant
MYO7A	autosomal dominant|autosomal recessive
PRSS1	autosomal dominant
TREH	autosomal recessive
TBXAS1	autosomal recessive
IDUA	autosomal recessive
MVK	autosomal recessive|autosomal dominant
BCKDHB	autosomal recessive
DBT	autosomal recessive
PNLIP	autosomal recessive
LTC4S	autosomal recessive
INVS	autosomal recessive
DLD	autosomal recessive
GCSH	autosomal recessive
GLDC	autosomal recessive
PCCB	autosomal recessive
PCCA	autosomal recessive
ETFDH	autosomal recessive
KLKB1	autosomal recessive
C6	autosomal recessive
CFI	autosomal dominant|autosomal recessive
FUT1	autosomal recessive
BBS1	autosomal recessive, digenic recessive
ACACA	autosomal recessive
ZP1	autosomal recessive
ZNF141	autosomal recessive
XRCC4	autosomal recessive
XRCC1	autosomal recessive
FLI1	autosomal dominant, autosomal recessive (1 family)
VCL	autosomal dominant
VIM	autosomal dominant
SLC18A2	autosomal recessive
VLDLR	autosomal recessive
AVP	autosomal dominant
VARS1	autosomal recessive
ATP6V1B1	autosomal recessive
ATP6V0A1	autosomal dominant|autosomal recessive
CDH1	autosomal dominant|autosomal dominant, somatic mutation|somatic mutation, autosomal dominant|somatic mutation
UMOD	autosomal dominant
PLAU	autosomal dominant
UGP2	autosomal recessive
UGT1A1	major gene effect in 11.5% of persons analyzed|autosomal recessive|autosomal recessive, autosomal dominant
UNG	autosomal recessive
DPAGT1	autosomal recessive
UCHL1	autosomal dominant|autosomal recessive
UQCRB	autosomal recessive
UQCRC2	autosomal recessive
UQCRC1	autosomal dominant
UQCRFS1	autosomal recessive
U2AF2	autosomal dominant
NTRK1	autosomal recessive
DDR2	autosomal recessive|autosomal dominant
KDR	autosomal dominant
BLK	autosomal dominant
TH	autosomal recessive
DCT	autosomal recessive
MAP3K8	somatic mutation, autosomal dominant
TNFRSF1A	autosomal dominant
TP53	autosomal dominant|somatic mutation, autosomal dominant|autosomal dominant, somatic mutation|somatic mutation|autosomal dominant, somatic mutation, multifactorial
TNFAIP3	autosomal dominant
TNF	autosomal dominant vs. multifactorial|autosomal dominant
TUBG1	autosomal dominant
TUBB	autosomal dominant
TUBA4A	autosomal dominant
TSC2	somatic mutation|autosomal dominant
TDO2	autosomal recessive
WARS1	autosomal recessive|autosomal dominant
TNNT2	autosomal dominant|autosomal dominant (1q3), other forms at loci on chromosomes 11, 14, 15 and at least one other locus
TNNI3	autosomal recessive|autosomal dominant
TNNI2	autosomal dominant
TNNT1	autosomal recessive|autosomal dominant
TNNC1	autosomal dominant
TNNC2	autosomal dominant
TPM3	autosomal dominant|autosomal recessive
TPM1	autosomal dominant|autosomal dominant (15), other forms at loci on chromosomes 1, 11, 14, and at least one other locus
TPM2	autosomal dominant
TPP2	autosomal recessive
TPI1	autosomal recessive
TCHH	autosomal recessive
SLC25A1	autosomal recessive
TGFB3	autosomal dominant
TGFB2	autosomal dominant
NOTCH1	autosomal dominant
CNTN2	autosomal recessive
TGM1	autosomal recessive
TGFBR2	somatic mutation, autosomal dominant|autosomal dominant
TGFBR1	autosomal dominant
TGFB1	autosomal recessive|autosomal dominant
THRB	autosomal dominant form, also a recessive form|autosomal recessive|autosomal dominant
ERBB3	autosomal recessive|autosomal dominant
THRA	autosomal dominant
SRC	autosomal dominant|somatic mutation, autosomal dominant
MYC	isolated cases, somatic mutation
KRAS	somatic mutation|autosomal dominant, somatic mutation|autosomal dominant|somatic mutation, autosomal dominant|autosomal dominant, somatic mutation, multifactorial|somatic mosaicism
MOS	autosomal recessive
PDGFB	autosomal dominant
HRAS	somatic mutation|autosomal dominant|somatic mosaicism|autosomal dominant, somatic mutation
TFRC	autosomal recessive
TF	autosomal recessive
ABL1	autosomal dominant|somatic mutation
TEAD1	autosomal dominant
GTF2E2	autosomal recessive
TPR	autosomal recessive
ZEB1	autosomal dominant
HNF1B	autosomal dominant
TTN	autosomal dominant|autosomal recessive
PRKAR1A	autosomal dominant
TIMP3	autosomal dominant
TRHR	autosomal recessive
TSHB	autosomal recessive
TG	autosomal recessive
TYMS	digenic, dominant
DTYMK	autosomal recessive
TK2	autosomal recessive
TBXA2R	autosomal dominant
THBS2	autosomal dominant
THBD	autosomal dominant
TARS1	autosomal recessive
TPMT	autosomal recessive
CLEC3B	autosomal dominant
TNC	autosomal dominant
TERT	autosomal dominant, somatic mutation|autosomal dominant|autosomal dominant, autosomal recessive
ITK	autosomal recessive
CD4	autosomal recessive
CD8A	autosomal recessive
TRAC	autosomal recessive
SLC6A6	autosomal recessive
PSMC3	autosomal recessive
CD81	autosomal recessive
CD3E	autosomal recessive
CD3D	autosomal recessive
CD247	autosomal recessive
CD3G	autosomal recessive
CD27	autosomal recessive
STX4	autosomal recessive
SDC3	autosomal dominant, autosomal recessive, multifactorial
VAMP2	autosomal dominant
VAMP1	autosomal recessive|autosomal dominant
SV2A	autosomal recessive
SURF1	autosomal recessive
SYT1	autosomal dominant
EPCAM	autosomal recessive|autosomal dominant
SDHB	autosomal dominant, isolated cases|autosomal recessive|autosomal dominant
NR5A1	autosomal dominant
SREBF1	autosomal dominant
SCP2	autosomal recessive
KITLG	autosomal dominant|autosomal recessive
CSTA	autosomal recessive
SOX4	autosomal dominant
SOX2	autosomal dominant
FDFT1	autosomal recessive
ZP3	autosomal dominant
ZP2	autosomal recessive
SPTB	autosomal dominant, autosomal recessive|autosomal dominant
SPTA1	autosomal dominant|autosomal recessive
SPTAN1	autosomal dominant
SPTBN1	autosomal dominant
SOS1	autosomal dominant
SORD	autosomal recessive
SON	autosomal dominant
SLC10A1	autosomal recessive
SCN3A	autosomal dominant
SCN2A	autosomal dominant
SCN1A	autosomal dominant
SLC5A2	autosomal dominant, autosomal recessive
SLC5A1	autosomal recessive
ATP1A3	autosomal dominant
ATP1A2	autosomal dominant|autosomal recessive
ATP1B1	multifactorial
ATP1A1	autosomal dominant
SLC34A1	autosomal recessive|autosomal dominant
SLC9A3	autosomal recessive
SNRPB	autosomal dominant
SLC6A4	autosomal dominant form
HTR2A	autosomal dominant form|autosomal dominant
SPR	autosomal recessive, ?autosomal dominant
SPARC	autosomal recessive
FUT2	autosomal recessive
STIL	autosomal recessive
SAG	autosomal recessive|autosomal dominant
AHCY	autosomal recessive
RYR3	autosomal recessive
RYR2	autosomal dominant
RYR1	autosomal dominant|autosomal recessive
ROM1	autosomal dominant, autosomal recessive, digenic dominant
POLR2A	autosomal dominant
RPS17	autosomal dominant
RPL35A	autosomal dominant
RNASEL	autosomal dominant form
RPIA	autosomal recessive
RRM1	autosomal recessive, autosomal dominant (in 1 patient)
RHO	autosomal dominant|autosomal dominant, autosomal recessive
RHAG	autosomal recessive|autosomal dominant
RBP3	autosomal recessive
RBP4	autosomal dominant|autosomal recessive
RARB	autosomal dominant, autosomal recessive
RBL2	autosomal recessive
KDM5A	autosomal recessive
RLBP1	autosomal recessive|autosomal dominant, autosomal recessive
PDE6G	autosomal recessive
PDE6B	autosomal dominant|autosomal recessive
PDE6A	autosomal recessive
RPE65	autosomal recessive|autosomal dominant
RD3	autosomal recessive
RPA1	autosomal dominant
REN	autosomal recessive|autosomal dominant
RAD51	autosomal dominant, somatic mutation|autosomal dominant
RAG2	autosomal recessive
RAG1	autosomal recessive
PRPH2	autosomal dominant|autosomal dominant, autosomal recessive, digenic dominant|autosomal dominant, autosomal recessive
PTPRF	autosomal recessive
RALA	autosomal dominant
RAP1B	autosomal dominant
RAP1GDS1	autosomal recessive
RDX	autosomal recessive
PDHA2	autosomal recessive
PDHB	autosomal recessive
PYCR1	autosomal recessive
PDXK	autosomal recessive
SFTPA2	autosomal dominant
SFTPB	autosomal recessive
SFTPA1	autosomal dominant, autosomal recessive (in 1 family)
SFTPC	autosomal dominant
BCHE	autosomal recessive
MAF	autosomal dominant
PRKCSH	autosomal dominant
PSMB8	autosomal recessive
PSMB9	autosomal dominant
PRKCG	autosomal dominant
PRKCD	autosomal recessive
MAPK1	autosomal dominant
ZAP70	autosomal recessive
EPHA2	autosomal dominant
FGFR2	autosomal dominant
TYK2	autosomal recessive
F2	autosomal dominant|multifactorial predisposition|autosomal recessive
PPP2CA	autosomal dominant
PRKAR1B	autosomal dominant
PRKG1	autosomal dominant
PRKACG	autosomal recessive
PRKACB	autosomal dominant, somatic mosaicism
PTPN1	autosomal dominant
PROS1	autosomal dominant|autosomal recessive
PTPN11	autosomal dominant|autosomal dominant, somatic mutation
MAP2K1	autosomal dominant|isolated cases
EIF2AK2	autosomal dominant, autosomal recessive (in 1 patient)|autosomal dominant
PSMB10	autosomal dominant|autosomal recessive
POMC	autosomal dominant, autosomal recessive, multifactorial|autosomal recessive
PTGER2	autosomal recessive
PSAP	autosomal dominant|autosomal recessive
P4HB	autosomal dominant
PRDX1	autosomal recessive
PRLR	autosomal dominant, autosomal recessive|autosomal dominant
PCNA	autosomal recessive
INS	autosomal dominant form (? 11q)|autosomal dominant, autosomal recessive (in 1 patient)|autosomal dominant
PHB1	autosomal dominant, somatic mutation
PRNP	'slow virus' etiology with ? genetic factors|autosomal dominant
PRIM1	autosomal recessive
PBX1	autosomal dominant
TTR	autosomal dominant
KCNA5	autosomal dominant
KCNA4	autosomal recessive
KCNC3	autosomal dominant
KCNA2	autosomal dominant
KCNE1	autosomal recessive|autosomal dominant
KCNA1	autosomal dominant
KCNC1	autosomal dominant
KCNC2	autosomal dominant
POLG	autosomal recessive|autosomal dominant
POLE	autosomal dominant|autosomal recessive
POLD1	autosomal dominant|autosomal recessive
PKD2	autosomal dominant
GP9	autosomal recessive
CD36	autosomal recessive
PDGFRA	autosomal dominant|somatic mutation, isolated cases
ITGB3	autosomal dominant|autosomal recessive
PDGFRB	autosomal dominant|autosomal dominant (12p13)
SERPINE1	autosomal recessive, autosomal dominant
PLG	autosomal dominant|autosomal recessive
ENPP1	autosomal dominant|autosomal dominant, autosomal recessive, multifactorial|autosomal recessive
JUP	autosomal dominant|autosomal recessive
SERPINB6	autosomal recessive
RNH1	autosomal recessive
POU1F1	autosomal dominant, autosomal recessive
SERPINF1	autosomal recessive
PHKB	autosomal recessive
PSPH	autosomal recessive
PHKG2	autosomal recessive
MTHFD1	? autosomal recessive|autosomal recessive
PAICS	autosomal recessive
PLCG1	autosomal dominant
PLA2G2A	somatic mutation, autosomal dominant
PLN	autosomal dominant
GPI	autosomal recessive
PGM3	autosomal recessive
PGM1	autosomal recessive
PIK3CA	autosomal dominant, somatic mutation|somatic mutation|somatic mosaicism|somatic mutation, autosomal dominant|autosomal dominant form
PIK3R1	autosomal recessive|autosomal dominant
ALPL	autosomal dominant, autosomal recessive|autosomal recessive
ACP2	autosomal recessive
ACP5	autosomal recessive
ABCB4	autosomal dominant, autosomal recessive (rare)|autosomal recessive|autosomal dominant, autosomal recessive
ABCD3	autosomal recessive
PEX2	autosomal recessive
PMP2	autosomal dominant
PRPH	autosomal dominant, autosomal recessive
PLIN1	autosomal dominant
NUP85	autosomal recessive
PRF1	autosomal recessive
TAP2	autosomal recessive
TAP1	autosomal recessive
DSG3	autosomal recessive
PTHLH	autosomal dominant
PTH1R	autosomal recessive|autosomal dominant
CCND1	somatic mutation, autosomal dominant|somatic mutation|autosomal dominant
PTH	autosomal dominant, autosomal recessive
SPINK1	autosomal dominant, autosomal recessive|autosomal dominant
PRRX1	autosomal recessive, autosomal dominant
PAX9	autosomal dominant
PAX8	autosomal dominant
PAX4	autosomal dominant (in 1 patient), autosomal recessive|autosomal dominant
PAX1	autosomal recessive
PAX7	autosomal recessive|somatic mutation
PAX2	autosomal dominant
ODC1	autosomal dominant
RHOA	somatic mosaicism
CBL	autosomal dominant, somatic mutation|autosomal dominant
WNT3	autosomal recessive
GLI3	autosomal dominant
GLI2	autosomal dominant
GLI1	autosomal recessive
MECOM	autosomal dominant
FGF5	autosomal recessive
SPI1	autosomal dominant
LYN	autosomal dominant
ERG	autosomal dominant
TRU-TCA1-1	autosomal recessive
WNT5A	autosomal dominant
FGF3	autosomal recessive
KIT	autosomal dominant, isolated cases|somatic mutation|autosomal dominant, somatic mutation|autosomal dominant|autosomal dominant (4q11-q12)
REL	autosomal recessive
FOXG1	autosomal dominant
ERBB2	autosomal recessive|somatic mutation, autosomal dominant|autosomal dominant, somatic mutation|somatic mutation
MET	autosomal dominant|autosomal recessive|somatic mutation
MYCN	autosomal dominant
WNT1	autosomal dominant|autosomal recessive
NRAS	autosomal dominant|somatic mutation, autosomal dominant|somatic mutation|somatic mosaicism|autosomal dominant, somatic mutation
MDM2	autosomal recessive|autosomal dominant
SKI	autosomal dominant
CSF1R	autosomal recessive|autosomal dominant
RET	autosomal dominant
RAF1	autosomal dominant
BRAF	somatic mutation, autosomal dominant|autosomal dominant
AKT2	autosomal dominant
AKT1	autosomal dominant, somatic mutation|somatic mutation, autosomal dominant|somatic mutation
ATP5F1A	autosomal recessive|autosomal dominant
OAS1	autosomal dominant
LEP	autosomal recessive
PNP	autosomal recessive
NPM1	autosomal dominant, somatic mutation
HNRNPC	autosomal dominant
HNRNPA1	autosomal dominant
MATR3	autosomal dominant
RELA	autosomal dominant
NFKB2	autosomal dominant
NFKB1	autosomal dominant
CHMP1A	autosomal recessive
NFKBIA	autosomal dominant
NFIX	autosomal dominant
SLC6A2	autosomal dominant
SNCA	autosomal dominant
NOS3	autosomal dominant|multifactorial|multifactorial predisposition
CXCR4	autosomal dominant
NHLH2	autosomal recessive
TACR3	autosomal recessive
TAC3	autosomal recessive
NEFL	autosomal dominant|autosomal dominant, autosomal recessive
NEFH	autosomal dominant, autosomal recessive|autosomal dominant
PCSK1	autosomal recessive
NRL	autosomal dominant
NGF	autosomal recessive
NEB	autosomal recessive
IL12B	autosomal recessive
NDUFV1	autosomal recessive
NQO2	autosomal dominant, somatic mutation
MYBPC1	autosomal dominant|autosomal recessive
MYL3	autosomal dominant, autosomal recessive
MYL2	autosomal dominant|autosomal recessive
MYL1	autosomal recessive
MYO5A	autosomal recessive
MYH9	autosomal dominant
MYL4	autosomal dominant
MYH7	autosomal dominant|autosomal dominant, digenic dominant (see miscellaneous)|autosomal recessive
MYH11	autosomal dominant|autosomal recessive
MYH8	autosomal dominant
MYH2	autosomal dominant, autosomal recessive
MYH3	autosomal dominant|autosomal recessive
MYH6	autosomal dominant
MB	autosomal dominant
MYF5	autosomal recessive
MYOD1	autosomal recessive
KMT2A	autosomal dominant
MPL	autosomal recessive|somatic mutation|autosomal dominant, somatic mutation
MOG	autosomal dominant
MAG	autosomal recessive
MPZ	autosomal dominant|autosomal dominant, autosomal recessive
MCC	somatic mutation, autosomal dominant
SLC20A2	autosomal dominant
MUC7	autosomal dominant vs. multifactorial
ABCC1	autosomal dominant
MUC1	autosomal dominant
CCL2	autosomal dominant
RMRP	autosomal recessive
NDUFS1	autosomal recessive
MTTP	autosomal recessive
MAPT	autosomal dominant, multifactorial|autosomal dominant|autosomal recessive vs. dominant with low penetrance and expression
MAP1B	autosomal dominant
MITF	autosomal recessive|autosomal dominant
MTR	? autosomal recessive|autosomal recessive
MARS1	autosomal recessive|autosomal dominant
MTAP	autosomal dominant
LAMA2	autosomal recessive
MN1	autosomal dominant
ACAN	autosomal dominant|autosomal recessive
MC1R	? autosomal recessive, red hair pigment possibly dominant to its absence and hypostatic to brown or black|autosomal recessive
MC4R	autosomal dominant, autosomal recessive
MC3R	broad locus on 20q
MAX	autosomal dominant
MGP	autosomal recessive
MAN2C1	autosomal recessive
MPI	autosomal recessive
MBL2	autosomal dominant
MAK	autosomal recessive
MDH1	autosomal recessive
MDH2	autosomal recessive
MIP	autosomal dominant
LIM2	autosomal dominant, autosomal recessive
LOXL1	autosomal dominant
LOX	autosomal dominant
PLOD1	autosomal recessive
LCK	autosomal recessive
LHCGR	sex-limited autosomal dominant|autosomal recessive
LHB	autosomal recessive
GNRH1	autosomal recessive
LORICRIN	autosomal dominant
KCNH2	autosomal dominant
ALOX5	autosomal dominant vs. multifactorial
LPA	autosomal dominant
LIPE	autosomal recessive
LIPC	autosomal dominant|autosomal recessive
PTPRC	autosomal recessive
LIFR	autosomal recessive
BCR	somatic mutation
RUNX1	autosomal dominant, somatic mutation|autosomal dominant
LARS1	autosomal recessive
LTBP1	autosomal recessive
RPSA	autosomal dominant
LMNB2	autosomal recessive|autosomal dominant
LMNB1	autosomal dominant
LMNA	autosomal dominant, ? a recessive form also|autosomal recessive|autosomal dominant
LAMB2	autosomal recessive
LAMA1	autosomal recessive
LAMB3	autosomal dominant|autosomal recessive
LAMC2	autosomal recessive
LAMB1	autosomal recessive
LDHA	autosomal recessive
KIF11	autosomal dominant
KRT10	autosomal dominant|autosomal recessive
KRT18	autosomal recessive cases, probably heterogeneous
KRT17	autosomal dominant
KRT16	autosomal dominant
KRT14	autosomal dominant|autosomal recessive
KRT13	autosomal dominant
KRT3	autosomal dominant
KRT6B	autosomal dominant
KRT6A	autosomal dominant
KRT5	autosomal dominant|autosomal recessive
DIO1	autosomal dominant
IL6R	autosomal recessive
IL1R1	autosomal dominant
JAK2	? autosomal recessive|autosomal dominant|autosomal dominant, somatic mutation|somatic mutation
JAK1	autosomal dominant
IL2RA	autosomal locus and allelic heterogeneity|autosomal recessive
IDH1	autosomal dominant, somatic mutation
IL13	autosomal dominant vs. multifactorial
IL1RN	autosomal recessive
INSR	autosomal recessive|autosomal dominant
IL6	multifactorial|somatic mutation|autosomal dominant|autosomal recessive susceptibility, heterogeneous
IREB2	autosomal recessive
IRF1	autosomal recessive|somatic mutation, autosomal dominant
IRF9	autosomal recessive
ISG15	autosomal recessive
IFNG	autosomal recessive|autosomal dominant
IFNGR2	autosomal recessive
ITGB6	autosomal recessive
ITGB4	autosomal recessive
ITGA6	autosomal recessive
IRS1	autosomal dominant
ITPA	autosomal recessive
IGF2	autosomal dominant (from paternal allele)
SOD1	autosomal dominant, autosomal recessive|autosomal recessive
IGF1	autosomal recessive
IGF1R	autosomal dominant, autosomal recessive
IGF2R	somatic mutation
ITPR3	autosomal recessive susceptibility, heterogeneous|autosomal dominant
ITPR1	autosomal dominant, autosomal recessive (in some patients)|autosomal dominant
CD79B	autosomal recessive
IGKC	autosomal recessive
RBPJ	autosomal dominant
TCF3	autosomal dominant|autosomal recessive
IGHM	autosomal recessive
IL10RA	autosomal recessive
CXCR2	autosomal recessive
ADAR	autosomal recessive|autosomal dominant
HLA-DQA1	autosomal recessive, multifactorial
FCGR2A	autosomal dominant|autosomal recessive
IGLL1	autosomal recessive
FCGR3A	autosomal recessive
INSL3	autosomal dominant
IL2RB	autosomal recessive
IMPDH1	autosomal dominant
IL7R	autosomal recessive
IL7	autosomal recessive
HIVEP2	autosomal dominant
MNX1	autosomal dominant
VSX2	autosomal recessive
HMX1	autosomal recessive
HOXD13	autosomal dominant
HOXD10	autosomal dominant
MSX1	autosomal dominant
HOXC13	autosomal recessive
HOXB1	autosomal recessive
HOXA13	autosomal dominant
HOXA11	autosomal dominant
HOXA1	autosomal recessive
HMGCR	autosomal recessive
HLA-G	autosomal dominant vs. multifactorial
HLA-DRB1	multifactorial|autosomal dominant
HLA-C	multifactorial
HLA-B	multifactorial
HARS1	autosomal dominant|autosomal recessive
HDC	autosomal dominant
HRG	autosomal dominant
HPCA	autosomal recessive
ABHD16A	autosomal recessive
HK1	autosomal recessive|autosomal dominant
HSPG2	autosomal recessive
HNF1A	autosomal recessive susceptibility, heterogeneous|autosomal dominant|autosomal dominant (12q22-qter)
HGF	autosomal recessive
HCK	autosomal dominant
SERPIND1	autosomal dominant
HBG2	autosomal dominant
H1-4	autosomal dominant
HBG1	autosomal dominant
HBB	autosomal dominant|autosomal recessive
HBA2	autosomal dominant
HBA1	autosomal dominant
HMOX1	autosomal recessive
NCKAP1L	autosomal recessive
GUCY1A1	autosomal recessive
GNB2	autosomal dominant
GNB1	autosomal dominant
GNAI3	autosomal dominant
GNAI2	autosomal dominant
KRT1	autosomal dominant
GNAT1	autosomal dominant|autosomal recessive
GNAS	somatic mutation|somatic mosaicism|autosomal dominant
GNA11	autosomal dominant
GNAL	autosomal dominant
GNAO1	autosomal dominant
GNAI1	autosomal dominant
GH1	autosomal recessive|autosomal dominant form
GHRHR	autosomal recessive
RASA1	autosomal dominant
GNB3	multifactorial|autosomal recessive
CSF2RB	autosomal recessive
CSF3R	autosomal dominant|autosomal recessive
GRN	autosomal dominant|autosomal recessive
GSC	autosomal recessive
GNRHR	autosomal recessive
HAGH	autosomal dominant
GP1BB	autosomal recessive
AHSG	autosomal recessive
GYS2	autosomal recessive
GYS1	autosomal recessive
GLRB	autosomal recessive
GLRA1	autosomal dominant, autosomal recessive
SLC25A32	autosomal recessive
CFB	autosomal recessive|autosomal dominant|digenic dominant
SHMT2	autosomal recessive
GPD2	autosomal dominant
GPD1	autosomal recessive
GPX4	autosomal recessive
GPX1	autosomal recessive
GSR	autosomal recessive
EPRS1	autosomal recessive
GFPT1	autosomal recessive
GLUL	autosomal recessive
GLS	autosomal dominant|autosomal recessive
GRIN2A	autosomal dominant
GRIN2B	autosomal dominant
ALDH18A1	autosomal dominant|autosomal recessive
GRIN1	autosomal recessive|autosomal dominant
GRIA1	autosomal recessive|autosomal dominant
GRIA2	autosomal dominant
GRIA4	autosomal dominant
GRIK2	autosomal recessive|autosomal dominant
GPT2	autosomal recessive
SLC2A2	autosomal dominant|autosomal recessive
GOT2	autosomal recessive
SLC2A1	autosomal dominant|autosomal dominant, autosomal recessive (rare)
GLUD1	autosomal dominant
H6PD	autosomal recessive
GCK	autosomal dominant|autosomal recessive
NR3C1	autosomal dominant
GCGR	autosomal recessive
MPV17	autosomal recessive
GFAP	autosomal dominant
GSN	autosomal dominant
GATA2	autosomal dominant, somatic mutation|autosomal dominant
TACSTD2	autosomal recessive
LRRC32	autosomal recessive
GABRB3	autosomal dominant
GABRB1	autosomal dominant
GGCX	autosomal recessive
SLC6A1	autosomal dominant
GABRG2	autosomal dominant
GABRD	autosomal dominant
GABRA1	autosomal dominant
ABAT	autosomal recessive
GABRA5	autosomal dominant
GABRA2	probably multifactorial, genetically influenced|autosomal dominant
FUS	autosomal dominant
B4GALT1	autosomal recessive
GAL	autosomal dominant
GALM	autosomal recessive
FH	autosomal recessive|autosomal dominant
FOXO1	somatic mutation
FSHB	autosomal recessive
KDSR	autosomal recessive
FSHR	autosomal recessive|autosomal dominant|autosomal recessive vs. multifactorial
FOLR1	autosomal recessive
FLT4	autosomal dominant
FLT3	autosomal dominant, somatic mutation
FGFR1	somatic mosaicism|autosomal dominant
FMO3	autosomal recessive
FLG	autosomal dominant, autosomal recessive (in some patients)
FBLN1	autosomal dominant
FN1	autosomal dominant
FGFR3	autosomal dominant|somatic mutation|autosomal dominant (1 family), autosomal recessive (1 family)|somatic mutation, autosomal dominant
FGG	autosomal recessive
FGB	autosomal recessive
FGA	autosomal recessive|autosomal dominant
FBN1	autosomal dominant
FTL	autosomal dominant|autosomal dominant, autosomal recessive
FTH1	autosomal dominant
FASLG	somatic mutation, autosomal dominant|autosomal dominant
FAS	autosomal dominant
FDPS	autosomal dominant
F13B	autosomal recessive
F13A1	autosomal dominant|autosomal recessive
CFHR1	autosomal recessive, autosomal dominant|autosomal dominant
CFH	autosomal recessive, autosomal dominant|autosomal dominant|autosomal dominant, also a recessive form, fleck retina disease (see 228980)|autosomal dominant, autosomal recessive
CFD	autosomal recessive
SLC1A1	autosomal recessive
ERCC5	autosomal recessive
ERCC4	autosomal recessive
ERCC3	autosomal recessive
ESR1	autosomal dominant|autosomal dominant, somatic mutation|autosomal recessive
EPOR	autosomal dominant
EPO	autosomal recessive|autosomal dominant
NR2F1	autosomal dominant
EPHX2	autosomal dominant, autosomal recessive
EGFR	autosomal recessive|somatic mutation, autosomal dominant
EGF	autosomal recessive
EPX	autosomal recessive
ENO3	autosomal recessive
PDYN	autosomal dominant
GATA3	autosomal dominant
EN1	autosomal recessive
EDNRB	autosomal recessive|autosomal dominant|autosomal dominant, autosomal recessive
EDNRA	autosomal dominant
EDN3	autosomal dominant|autosomal dominant, autosomal recessive
EDN1	autosomal recessive|autosomal dominant
ANXA5	autosomal dominant
TYMP	autosomal recessive
ENG	autosomal dominant
EMILIN1	autosomal dominant
RPS14	somatic mutation, isolated cases
EEF2	autosomal dominant
EPB41	autosomal dominant, autosomal recessive
ETFB	autosomal recessive
ELN	autosomal dominant
ELANE	autosomal dominant
NT5E	autosomal recessive
EGR2	autosomal dominant|autosomal dominant, autosomal recessive|autosomal recessive, autosomal dominant (in 1 patient)
SNRPE	autosomal dominant
DAG1	autosomal recessive
SLC26A3	autosomal recessive
SLC6A3	genetic factors seem to contribute only in light smokers and heavy smokers|autosomal recessive
DRD5	autosomal dominant
DRD4	autosomal dominant
DRD3	autosomal dominant
TOP2B	autosomal dominant
LIG1	autosomal recessive
ERCC1	autosomal recessive
DNMT1	autosomal dominant
DNASE2	autosomal recessive
ERCC2	autosomal recessive
DPP6	autosomal dominant
PCBD1	autosomal recessive
CYP24A1	autosomal recessive
DHODH	autosomal recessive
DLST	autosomal dominant
DHFR	autosomal recessive
DSG2	autosomal dominant|autosomal recessive
DSG1	autosomal recessive|autosomal dominant
DES	autosomal dominant|autosomal dominant, autosomal recessive
DSP	autosomal dominant|autosomal recessive
DSC2	autosomal dominant, autosomal recessive
DNASE1	autosomal dominant
DSPP	autosomal dominant
ALAD	autosomal recessive
DCN	autosomal dominant
CD55	autosomal recessive
IL10	unproved inheritance
COX6B1	autosomal recessive
CYP11B2	autosomal recessive
CYP2D6	autosomal recessive
CYP2C19	autosomal recessive
POR	autosomal recessive
CYP3A4	autosomal dominant
CYC1	autosomal recessive
CYCS	autosomal dominant
KRT4	autosomal dominant
CTLA4	autosomal dominant
IL10RB	autosomal recessive
COX8A	autosomal recessive
COX4I1	autosomal recessive
CTPS1	autosomal recessive
CARS1	autosomal recessive
PPIB	autosomal recessive
CCND2	autosomal dominant
CDK5	autosomal recessive
CNP	autosomal recessive
CDK4	autosomal dominant
CNGA1	autosomal recessive
PDE3A	autosomal dominant
CRYM	autosomal dominant
CRYGS	autosomal dominant
PCYT1A	autosomal recessive
CRYGD	autosomal dominant
CRYGC	autosomal dominant
CRYGB	autosomal dominant
CRYBA4	autosomal dominant
CRYBB3	autosomal dominant, autosomal recessive
CRYBB2	autosomal dominant
CRYBA1	autosomal dominant (17q11-q12)
CRYAB	autosomal dominant|autosomal dominant, autosomal recessive|autosomal recessive
CRYAA	autosomal dominant, autosomal recessive
MSX2	autosomal dominant
CYP2A6	somatic mutation, autosomal dominant|genetic factors seem to contribute only in light smokers and heavy smokers|autosomal dominant
SERPINA6	autosomal dominant, autosomal recessive
CBFB	autosomal dominant
GJA3	autosomal dominant
GJA1	autosomal recessive|autosomal dominant
GJA5	autosomal dominant
GJB2	autosomal dominant|autosomal recessive, digenic dominant (see miscellaneous)
C8B	autosomal recessive
C8A	autosomal recessive
C9	autosomal dominant
CD46	autosomal recessive, autosomal dominant
C5	autosomal dominant|autosomal recessive
C4A	autosomal recessive
C3	autosomal dominant|autosomal recessive
CR2	autosomal recessive
C1S	autosomal dominant
C1QC	autosomal recessive
C1QB	autosomal recessive
C1QA	autosomal recessive
MME	autosomal dominant|autosomal recessive, autosomal dominant
DCC	somatic mutation, autosomal dominant|autosomal recessive|autosomal dominant
MLH1	autosomal recessive|autosomal dominant
MMP9	autosomal recessive
MMP2	autosomal recessive
COL13A1	autosomal recessive
COL18A1	autosomal dominant|autosomal recessive
COL12A1	autosomal recessive|autosomal dominant
COL11A2	autosomal dominant|autosomal recessive|autosomal dominant, autosomal recessive
COL11A1	autosomal dominant|autosomal recessive
COL9A3	autosomal dominant|autosomal recessive
COL9A2	autosomal recessive|autosomal dominant
COL8A2	autosomal dominant
COL6A3	autosomal dominant|autosomal recessive|autosomal dominant, autosomal recessive
COL6A2	autosomal recessive|autosomal dominant, autosomal recessive (uncommon)|autosomal dominant, autosomal recessive
COL6A1	autosomal dominant|autosomal recessive, autosomal dominant
COL5A1	autosomal dominant
COL9A1	autosomal dominant|autosomal recessive
COL5A2	autosomal dominant
COL3A1	autosomal dominant|autosomal recessive
COL1A2	autosomal dominant|autosomal recessive
COL1A1	autosomal dominant
COL2A1	autosomal dominant|autosomal dominant vs. multifactorial
COL4A4	autosomal recessive|autosomal dominant
COL4A1	autosomal dominant
COL7A1	autosomal recessive|autosomal dominant|autosomal dominant, autosomal recessive
COL10A1	autosomal dominant
COL4A2	autosomal dominant
COL4A3	autosomal dominant
CLTC	autosomal dominant
VCAN	autosomal dominant
CHRNA4	genetic factors seem to contribute only in light smokers and heavy smokers|autosomal dominant
CHRNA3	autosomal recessive
CHRNA2	autosomal dominant
CHRM3	autosomal recessive
CHKA	autosomal recessive
CHAT	autosomal recessive
CETP	autosomal dominant
CLCN1	autosomal dominant|autosomal recessive
CHN1	autosomal dominant
HSPD1	autosomal recessive|autosomal dominant
CP	autosomal recessive
CENPE	autosomal recessive
CNBP	autosomal dominant
CDC42	autosomal dominant
MCM2	autosomal dominant
CEBPA	autosomal dominant, somatic mutation
CUX1	autosomal dominant
CTSD	autosomal recessive
CTSB	autosomal dominant
CTNNB1	somatic mutation, autosomal dominant|autosomal dominant|somatic mutation|somatic mutation, autosomal dominant, autosomal recessive
CTNNA1	autosomal dominant
COMT	? autosomal dominant form|autosomal dominant
TYRP1	autosomal recessive
CSNK2B	autosomal dominant
CSNK2A1	autosomal dominant
CPE	autosomal recessive
CEL	autosomal dominant
CES1	autosomal dominant
CA8	autosomal recessive
CA5A	autosomal recessive
NUP214	autosomal recessive|autosomal dominant, somatic mutation
CASQ2	autosomal recessive
CASQ1	autosomal dominant
CAPN3	autosomal dominant|autosomal recessive
CAPN1	autosomal recessive
CACNA1S	autosomal dominant|autosomal dominant, autosomal recessive
CACNA1D	autosomal dominant|autosomal recessive
CACNA1C	autosomal dominant
CACNA2D1	autosomal recessive
CALCRL	autosomal recessive
CALM3	autosomal dominant
CALM2	autosomal dominant
CALM1	autosomal dominant
CAPNS1	autosomal recessive
CALCR	autosomal dominant
PPP3CA	autosomal dominant
CAST	autosomal recessive
CAMK2A	autosomal recessive|autosomal dominant
CTNNA2	autosomal recessive
CDH3	autosomal recessive
CDH2	autosomal recessive|autosomal dominant
CDH15	autosomal dominant
CAD	autosomal recessive
COL17A1	autosomal recessive|autosomal dominant
DST	autosomal recessive
BRCA1	autosomal dominant, multifactorial|autosomal recessive
RPL13	autosomal dominant
BCAT2	autosomal recessive
BMP6	autosomal dominant
BMP1	autosomal recessive
BMP4	autosomal dominant|? familial predisposition
BMP2	autosomal recessive|autosomal dominant
MS4A1	autosomal recessive
CD79A	autosomal recessive
RHCE	autosomal recessive
RHD	isolated cases (see miscellaneous below)
HTR1A	autosomal dominant
BLVRA	autosomal dominant, autosomal recessive
B2M	autosomal recessive
ADRB3	autosomal dominant, autosomal recessive, multifactorial
ADRB1	autosomal dominant
CD40	autosomal recessive
SLC4A2	autosomal recessive
SLC4A1	autosomal dominant|autosomal recessive
CALR	somatic mutation|autosomal dominant
NPR3	autosomal recessive
NPR2	autosomal recessive|autosomal dominant
NPPA	autosomal dominant|autosomal recessive
ATP6V1E1	autosomal recessive
ATP6V0C	autosomal dominant
ATP2A2	autosomal dominant
ATP2B2	autosomal recessive|autosomal dominant
ATP2B1	autosomal dominant
ATP2A1	autosomal recessive
NARS1	autosomal recessive|autosomal dominant
ASNS	autosomal recessive
DDC	autosomal recessive
CYP19A1	male-limited autosomal dominant vs. autosomal recessive or x-linked
RARS1	autosomal recessive
AQP2	autosomal dominant, autosomal recessive
NR2F2	autosomal dominant
LRP1	autosomal recessive|autosomal dominant
APOE	autosomal dominant|autosomal dominant allele (19q) with additional multifactorial component in late-onset cases|autosomal recessive, ? same as the adult, chronic or b form of niemann-pick disease
APOB	autosomal dominant|autosomal recessive
APOA1	autosomal recessive|autosomal dominant
APOA2	autosomal dominant, autosomal recessive
TFAP2A	autosomal dominant
IFNGR1	not determined|autosomal recessive|autosomal dominant
IFNAR1	autosomal recessive
SERPINA1	autosomal recessive
ALDH7A1	autosomal recessive
SLC9A1	autosomal recessive
SERPINC1	autosomal dominant, autosomal recessive
CD59	autosomal recessive
CD19	autosomal recessive
ANK2	autosomal dominant
SLC4A3	autosomal dominant
ACE	autosomal recessive
AGTR1	multifactorial|autosomal recessive
AGT	multifactorial|autosomal recessive
APP	autosomal dominant
ACY1	autosomal recessive
SLC3A1	autosomal dominant, autosomal recessive
PSEN1	autosomal dominant
LRPAP1	autosomal recessive
ADRA2A	autosomal dominant
NAGA	autosomal recessive
GANAB	autosomal dominant
ZFHX3	autosomal dominant|somatic mutation, autosomal dominant
AFP	autosomal dominant|autosomal recessive
ALDOA	autosomal recessive
ADH1C	probably multifactorial, genetically influenced|autosomal dominant, multifactorial
ADH1B	probably multifactorial, genetically influenced
ADH5	digenic, recessive
ALB	autosomal dominant, autosomal recessive|autosomal recessive
AGRN	autosomal recessive
FDXR	autosomal recessive
SLC25A4	autosomal dominant|autosomal recessive
ARF1	autosomal dominant
ADCY1	autosomal recessive
AK2	autosomal recessive
AK1	autosomal recessive
ATP5F1B	autosomal dominant
AMPD3	autosomal recessive
AMPD2	autosomal recessive
AMPD1	autosomal recessive
ADK	autosomal recessive
ADD1	multifactorial
ACTB	autosomal dominant|somatic mutation
ACTA2	autosomal dominant
ACTA1	autosomal dominant|autosomal recessive
APRT	autosomal recessive
STAT3	autosomal dominant
RFC1	autosomal recessive
ACVR1	autosomal dominant
ACTN1	autosomal dominant
ACTN3	autosomal recessive
ACTN2	autosomal dominant
ACTG1	autosomal dominant
ACTG2	autosomal dominant
ACTC1	autosomal dominant
ACR	autosomal recessive
ACO2	autosomal recessive|autosomal recessive, autosomal dominant
CHRNG	autosomal recessive
CHRNE	autosomal dominant, autosomal recessive (rare)|autosomal recessive
CHRND	autosomal dominant|autosomal recessive
CHRNB1	autosomal recessive|autosomal dominant
CHRNA1	autosomal recessive|autosomal dominant|autosomal dominant, autosomal recessive
ACAT2	isolated cases
ALDH2	autosomal dominant